this day i will cherish	ngày này tôi sẽ trân_trọng
which newspaper do you read	bạn_đọc tờ báo nào
will haven and hold you	sẽ thiên_đường và giữ bạn
what is your favorite book	cuốn sách yêu_thích của_bạn là_gì
i am always positive	tôi luôn luôn tích_cực
i did not ask you to spend all the money	tôi đã không yêu_cầu bạn tiêu hết tiền
can i have a different brand, please	tôi có_thể có một thương_hiệu khác, xin vui_lòng
when are you going to delhi	khi nào bạn sẽ đến delhi
don't move with them	đừng di_chuyển với họ
how is the weather like	thời_tiết như thế_nào
sir, i am basically a commerce graduate and i have completed my advanced diploma in computers	thưa ông, tôi về cơ_bản là một sinh_viên tốt_nghiệp thương_mại và tôi đã hoàn_thành bằng tốt_nghiệp nâng cao về máy_tính
where to check-in for indian airlines flight to delhi	nơi để đăng_ký chuyến bay của hãng hàng_không ấn_độ đến delhi
when did you meet him last	bạn gặp anh_ấy khi nào
he came here	anh_ấy đến đây
when is the next bus to gandhi nagar	khi nào thì xe_buýt tiếp_theo đến gandhi_nagar
i like travelling by train	tôi thích đi du_lịch bằng tàu_hỏa
how do i get to the nearest shopping center	làm_cách_nào để đến trung_tâm mua_sắm gần nhất
why are you late	tại_sao bạn trễ
i feel thirsty	tôi cảm thấy khát_nước
sir, how much would i lose if i cancelled the ticket	thưa ông, tôi sẽ mất bao_nhiêu nếu tôi hủy vé
is she your sister	cô_ấy có phải là em_gái của_bạn không
did he award him	anh_ấy đã trao cho anh_ấy
okay, it doesn't matter, but don't let it happen again	được rồi, không thành vấn_đề, nhưng đừng để nó xảy ra lần nữa
i am living in london	tôi đang sống ở london
could you tell me something about your family	bạn có_thể cho tôi biết điều gì đó về gia_đình của_bạn
that bird is her most feared animal 	con_chim đó là con_vật đáng sợ nhất của cô_ấy
do you have any plans for the weekend	bạn có kế_hoạch nào cho cuối tuần không
new jersey is pleasant during fall	new_jersey rất dễ_chịu trong mùa_thu
do you have any recommendations for wine tasting	bạn có bất_kỳ khuyến_nghị cho nếm rượu_vang
i am bold	tôi can_đảm
she has bird	cô_ấy có chim
i am in love with the shape of you	tôi yêu hình_dạng của bạn
do you have any recommendations for hiking trails	bạn có bất_kỳ khuyến_nghị cho những con_đường_mòn đi bộ đường dài
what exactly is the disease	chính_xác thì bệnh là_gì
i got so nervous i could not speak	tôi rất lo_lắng , tôi không_thể nói được
i have a very bad earache	tôi có một cơn đau tai rất xấu
sir, it is midnight. please switch off the light. i feel sleepy	thưa ông, đó là nửa_đêm . vui_lòng tắt đèn . tôi cảm_thấy buồn_ngủ
what did you say	bạn nói gì
don't lose your temper	đừng mất bình_tĩnh
we are birds	chúng_tôi là những con_chim
thank you so much	cảm_ơn bạn rất nhiều
i’m sorry, i don’t understand	tôi xin_lỗi, tôi không hiểu
i don't feel like talking to anybody	tôi không cảm_thấy muốn nói_chuyện với bất_cứ ai
i have come to the end of my patience	tôi đã đi đến cuối sự kiên_nhẫn của_tôi
i am sorry it is wrong number	tôi xin_lỗi nó là số sai
we are living in wisconsin	chúng_tôi đang sống ở wisconsin
do you have school today	hôm_nay bạn có đi học không
you should have replied to his letter	bạn nên trả_lời thư của anh_ấy
there are four members in our family	có bốn thành_viên trong gia_đình của chúng_tôi
when is he reporting for duty	khi nào anh_ấy báo_cáo cho nhiệm_vụ
paris is sometimes wonderful during autumn	paris đôi_khi tuyệt_vời trong mùa_thu
listening to our favourite song	nghe bài hát yêu_thích của chúng_tôi
your friend sundar called. he has asked you to come to the regal theatre at 6.30	người_bạn của_bạn sundar đã gọi . anh_ấy đã yêu_cầu bạn đến nhà_hát regal lúc 6 h30
i am a b.com., graduate	tôi là một b.com ., tốt_nghiệp
i hope she has your eyes	tôi hy_vọng cô_ấy có đôi mắt của bạn
their favorite fruit is the mango	trái_cây yêu_thích của họ là xoài
do you have any recommendations for live music venues	bạn có bất_kỳ đề_xuất cho các địa_điểm âm_nhạc trực_tiếp
china is never nice during july	trung_quốc không_bao_giờ tốt_đẹp trong tháng_bảy
don't let them in, don't let them see	đừng để họ vào , đừng để họ thấy
is mala telling a story	mala đang kể một câu_chuyện
what did you do yesterday	bạn đã làm gì ngày hôm_qua
i like peaches	tôi thích đào
what time is it	mấy giờ rồi
where have you kept the book	bạn đã giữ cuốn sách ở_đâu
which bus goes to gandhi nagar	xe_buýt nào đi đến gandhi_nagar
where is the immigration check counter	bộ đếm kiểm_tra nhập_cư ở_đâu
our master has asked us to utter all the sentences	chủ_nhân của chúng_tôi đã yêu_cầu chúng_tôi thốt ra tất_cả các câu
did you switch off the t.v.	bạn đã tắt_t.v.
oh, oh, uh, uh	oh , oh , uh , uh
france is sometimes quiet during december	pháp đôi_khi im_lặng trong tháng_12
excuse me. do you have change for rs.500	xin_lỗi . bạn có thay_đổi với giá 500 rupee không
i am looking for a job	tôi đang tìm việc
everything you touch surely dies	mọi thứ bạn chạm vào chắc_chắn chết
well, you let her go	chà , bạn đã để cô_ấy đi
i like bananas	tôi thích chuối
you had better consult your father	bạn đã tham_khảo ý_kiến cha của_bạn tốt hơn
please tell him that suresh called	xin vui_lòng nói với anh_ấy rằng suresh gọi
what is your name	tên của_bạn là_gì
the united states is never nice during february	hoa_kỳ không_bao_giờ tốt_đẹp trong tháng_hai
i feel tired	tôi cảm_thấy mệt
in which department is latha working	latha đang hoạt_động ở bộ_phận nào
what did you buy	bạn đã mua gì
please help yourself	xin hãy tự giúp mình
i am mrs. catherine	tôi là bà catherine
he is my colleague	anh_ấy là đồng_nghiệp của_tôi
the strawberry is my most loved fruit	quả_dâu là trái_cây được yêu_thích nhất của tôi
she shares my dreams, i hope that someday i will share her home	cô_ấy chia_sẻ ước_mơ của tôi , tôi hy_vọng rằng một ngày nào đó tôi sẽ chia_sẻ nhà của cô_ấy
what the devil are you doing there	bạn đang làm cái quái gì ở đó
can not hold it back anymore	không_thể giữ nó lại nữa
he is my elder brother	anh_ấy là anh_trai của_tôi
arrange the books in order	sắp_xếp các cuốn sách theo thứ_tự
darling, just hold my hand	em_yêu , chỉ cần nắm tay tôi
he studied in st. andrew's school	anh_ấyhọc tại trường st . andrew
i am mrs. obama	tôi là bà obama
do you like this movie	bạn có thích phim này không
california is never cold during february	california không_bao_giờ lạnh trong tháng_hai
where are you working	bạn đang làm_việc ở_đâu
what is your qualification	trình_độ của_bạn là_gì
what we have is timeless	những gì chúng_ta có là vượt thời_gian
i think it will rain today	tôi nghĩ hôm_nay trời sẽ mưa
what did he ask you	anh_ấy đã hỏi bạn điều gì
can i have the check, please	tôi có_thể có séc không
china is cold during fall	trung_quốc lạnh trong mùa_thu
are you satisfied now	bây_giờ bạn có hài_lòng không
can i go to work next week	tôi có_thể đi làm vào tuần tới không
why don't you do some computer course	tại_sao bạn không làm một_số khóa học máy_tính
where do they send this parcel to	họ gửi bưu_kiện này đến đâu
and if a daughter is what our future holds	và nếu con_gái là những gì tương_lai của chúng_ta giữ
your least liked fruit is the mango	trái_cây ít thích nhất của bạn là xoài
can i have a different style	tôi có_thể có một phong_cách khác không
i have no time	tôi không có thời_gian
let the storm rage on	hãy để cơn bão cơn thịnh_nộ
how far have you studied	bạn đã học bao_xa
where do you work	bạn làm ở_đâu
is your wife employed	vợ bạn có được tuyển_dụng không
the united states is usually dry during winter	hoa_kỳ thường khô trong mùa_đông
does he approve the idea	anh_ấy có chấp_thuận ý_tưởng không
don't worry. i too have the same problem	đừng lo_lắng . tôi cũng có vấn_đề tương_tự
can i get the return ticket here	tôi có_thể nhận được vé trả lại ở đây không
with whom did you come	bạn đã đến với ai
i must return this book today	tôi phải trả lại cuốn sách này ngày hôm_nay
i plan to visit california next october 	tôi dự_định đến thăm california vào tháng_10 tới
did he servant bow	anh_ấy có phải người_hầu không
can i have a different style of painting, please	tôi có_thể có một phong_cách hội họa khác nhau được không
how many brothers do you have	bạn có bao_nhiêu anh_em
the grapefruit is my most loved fruit	quả bưởi là trái_cây được yêu_thích nhất của tôi
shall i ask him to call you up	tôi có nên yêu_cầu anh_ấy gọi cho bạn không
my father is very honest	cha tôi rất trung_thực
and from now 'til my very last breath	và từ bây_giờ cho đến khi tôi hơi thở cuối_cùng của tôi
can i have a different type of tea, please	tôi có_thể có một loại trà khác không
when is the manager returning from trichy	khi nào người quản_lý trở_về từ trichy
what is your favorite type of marine animal	loại động_vật biển yêu_thích của_bạn là_gì
they send this parcel to kanyakumari	họ gửi bưu_kiện này đến kanyakumari
where do you buy the vegetables	bạn mua rau ở_đâu
i am residing at london	tôi đang cư_trú tại london
i apologise. it was my mistake	tôi xin_lỗi . đó là sai_lầm của_tôi
do you have any recommendations for historical villages	bạn có bất_kỳ khuyến_nghị cho các làng lịch_sử
china is usually nice during april	trung_quốc thường rất tốt trong tháng_tư
how did you convince them	làm thế_nào bạn thuyết_phục họ
can i have a different style of fashion, please	tôi có_thể có một phong_cách thời_trang khác nhau được không
do you have any recommendations for historic villages	bạn có bất_kỳ khuyến_nghị cho các làng lịch_sử
how do i get to the nearest museum	làm_cách_nào để đến bảo_tàng gần nhất
every day discovering something brand new	mỗi ngày khám_phá một cái gì đó hoàn_toàn mới
how old are you	bạn bao_nhiêu tuổi
oh, i never knew you were the someone waiting for me	ồ , tôi chưa bao_giờ biết bạn là ai đó đang đợi tôi
paris is usually beautiful during may	paris thường đẹp trong tháng_5
i bought this shirt yesterday	tôi đã mua chiếc áo này ngày hôm_qua
where did you have your school education	bạn đã học ở_đâu
the new house is very convenient	ngôi_nhà mới rất thuận_tiện
my power flurries through the air into the ground	sức_mạnh của tôi bay qua không_khí xuống đất
i would like to meet the manager. i have a complaint to make	tôi muốn gặp người quản_lý . tôi có một khiếu_nại để thực_hiện
the pear is our least liked fruit	quả lê là trái_cây ít thích nhất của chúng_tôi
ask him not to go there	yêu_cầu anh_ta không đến đó
the lime is her least liked fruit	vôi là trái_cây ít thích nhất của cô_ấy
when is the next flight to delhi	chuyến bay tiếp_theo đến delhi là khi nào
how long will you wait	bạn sẽ đợi bao_lâu
just a minute please	vui_lòng đợi một phút
he dislikes grapefruit	anh_ấy không thích bưởi
he doesn't have time	anh_ấy không có thời_gian
do you have any recommendations for day trips	bạn có bất_kỳ khuyến_nghị cho các chuyến đi trong ngày
my brother is very adamant	anh_ấytrai tôi rất kiên_quyết
our least favorite fruit is the banana	trái_cây yêu_thích nhất của chúng_tôi là chuối
you ought to wear a helmet while travelling	bạn nên đội mũ_bảo_hiểm khi đi du_lịch
what is the difference between these two	sự khác_biệt giữa hai cái đó là_gì
i buy the hindu as well	tôi cũng mua người theo đạo_hindu
i found a lover, to carry more than just my secrets	tôi đã tìm thấy một người_yêu , để mang nhiều hơn chỉ là bí_mật của tôi
when is he returning	khi nào anh_ấy trở_lại
india is sometimes rainy during january	ấn_độ đôi_khi mưa trong tháng_1
why are you staring at me	tại_sao bạn nhìn chằm_chằm vào tôi
where do i ask sita to wait	tôi yêu_cầu sita chờ_đợi ở_đâu
did you get there on time	bạn đã đến đó đúng giờ
can i have a discount, please	tôi có_thể giảm_giá được không
i live in london	tôi sống ở london
who does your printing job	công_việc in_ấn của_bạn là ai
ask the children not to get wet in the rain	yêu_cầu bọn trẻ không bị ướt trong mưa
i don't deserve this	tôi không xứng_đáng với điều này
did you lock the door	bạn đã khóa cửa
they are birds	chúng là những con_chim
why did you spend all the money	tại_sao bạn tiêu hết tiền
'cause we were just kids when we fell in love	vì chúng_tôi chỉ là những đứa trẻ khi chúng_tôi yêu
i will ask him to meet you tomorrow at 5 o'clock	tôi sẽ yêu_cầu anh_ấy gặp bạn vào ngày_mai lúc 5 oclock
have you announced the entrance test results	bạn đã công_bố kết_quả kiểm_tra đầu_vào chưa
although my heart is falling too	mặc_dù trái_tim tôi cũng đang rơi xuống
how do i know that	làm thế_nào để tôi biết điều đó
do you work on sundays	bạn có làm_việc vào chủ_nhật không
whose mistake is it	đó là sai_lầm của ai
don't you have a pen	bạn không có bút
paris is sometimes warm during june	paris đôi_khi ấm_áp trong tháng_6
it is. bir	nó là . chi
which bus has just left	xe_buýt nào vừa rời đi
he lives at paris in france	anh_ấysống ở paris ở pháp
we have some guests at home	chúng_tôi có một_số khách ở nhà
do you have any recommendations for sightseeing	bạn có bất_kỳ khuyến_nghị để tham_quan
we have a function at home tomorrow	chúng_ta có một chức_năng ở nhà vào ngày_mai
he has asked you to call him at his residence	anh_ấy đã yêu_cầu bạn gọi cho anh_ấy tại nơi cư_trú của anh_ấy
he is working as a software engineer in wipro	anh_ấy đang làm_việc như một kỹ_sư phần_mềm ở wipro
paris is never quiet during spring	paris không_bao_giờ yên_tĩnh trong mùa_xuân
don't worry. everything will go off well	đừng lo_lắng . mọi thứ sẽ diễn ra tốt_đẹp
can i have an application form for sb account please	tôi có_thể có một mẫu_đơn cho tài_khoản sb được không
china is freezing during july	trung_quốc đang đóng_băng trong tháng_bảy
are you trying to make a fool of me	bạn đang cố_gắng làm cho tôi một kẻ ngốc
how do you think that you are fit for the job	làm thế_nào để bạn nghĩ rằng bạn phù_hợp với công_việc
is he paying the fee	anh_ta đang trả phí
my floppy drive is not working properly and at times my computer keeps freezing up	ổ_đĩa_mềm của_tôi không hoạt_động tốt và đôi_khi máy_tính của_tôi tiếp_tục đóng băng
i think it is time for dinner, shall we	tôi nghĩ rằng đã đến lúc ăn tối, phải không
don't rush me	đừng vội_vàng tôi
when does the train reach bangalore	khi nào tàu đến bangalore
take them with you	mang chúng với bạn
ask your friend surya to meet me tomorrow	yêu_cầu bạn của_bạn surya gặp tôi vào ngày_mai
my life had found its missing piece	cuộc_sống của tôi đã tìm thấy mảnh còn thiếu của nó
so beautiful in white	đẹp quá
france is sometimes quiet during may	pháp đôi_khi yên_tĩnh trong tháng_năm
my throat is a bit dry	cổ_họng tôi hơi khô
when can i get the medical report	khi nào tôi có_thể nhận được báo_cáo y_tế
what is your favorite type of flower	loại hoa yêu_thích của_bạn là_gì
sir, i agree with you i have no experience. but i am a fast learner sir	thưa ông, tôi đồng_ý với bạn, tôi không có kinh_nghiệm . nhưng tôi là một người học nhanh
don't quarrel with him	đừng cãi nhau với anh_ta
please ask him to call my residence	xin vui_lòng yêu_cầu anh_ấy gọi cho nơi cư_trú của_tôi
i don't like waiting in queues	tôi không thích chờ_đợi trong hàng đợi
make yourself comfortable	làm cho bản_thân bạn thấy thoải_mái
when can i collect the x-ray	khi nào tôi có_thể thu_thập x-quang
i am looking for a challenging job sir	tôi đang tìm_kiếm một công_việc đầy thách_thức
shall i ask them to come tomorrow	tôi sẽ yêu_cầu họ đến vào ngày_mai
they are vacating the house next month	họ sẽ rời khỏi nhà vào tháng_tới
where does he work	anh_ấy làm_việc ở_đâu
that cat was my most loved animal 	con_mèo đó là con_vật được yêu_thích nhất của tôi
paris is never hot during summer	paris không_bao_giờ nóng trong mùa_hè
you and me are thrifty, so go all you can eat	bạn và tôi rất tiết_kiệm , vì_vậy hãy đi tất_cả những gì bạn có_thể ăn
does she behold me	cô_ấy có nhìn thấy tôi không
i really don't know how to express my thanks to you	tôi thực_sự không biết làm thế_nào để bày_tỏ lời cảm_ơn của_tôi đến bạn
sir, i am new to this town. i am working in kaveri chemicals. this is my identity card. will this card do to open the account	thưa ông, tôi mới đến thị_trấn này . tôi đang làm_việc trong kaveri chemicals . đây là thẻ danh_tính của_tôi . thẻ này sẽ làm để mở tài_khoản
i am a housewife	tôi là nội_trợ
what is your favorite type of bird	loại chim yêu_thích của_bạn là_gì
what is your favorite type of coffee	loại cà_phê yêu_thích của_bạn là_gì
i have ford car	tôi có xe ford
how is the new house	ngôi_nhà mới thế_nào
agriculture is the major occupation of the people there in	nông_nghiệp là nghề_nghiệp chính của người dân ở đó
what is the capital of this country	thủ_đô của đất_nước này là_gì
you see her when you close your eyes	bạn nhìn thấy cô_ấy khi bạn nhắm_mắt
have a nice day	chúc một ngày tốt_lành
i am glad that you have come	tôi rất vui vì bạn đã đến
please pack it up neatly	vui_lòng đóng_gói nó gọn_gàng
he just made a courtesy visit	anh_ấy chỉ thực_hiện một chuyến thăm lịch_sự
and how your family is doing okay	và gia_đình bạn đang làm như thế_nào
don't eat too much	đừng ăn quá nhiều
are you ready	bạn đã sẵn_sàng chưa
do you have a pen	bạn có bút không
we push and pull like a magnet do	chúng_tôi đẩy và kéo như một nam_châm làm
what station is it	đó là trạm nào
what is your favorite historical figure	con_số lịch_sử yêu_thích của_bạn là_gì
hoping one day you will make a dream last	hy_vọng một ngày nào đó bạn sẽ thực_hiện một giấc mơ cuối_cùng
why do you worry	tại_sao bạn lo_lắng
he is my classmate	anh_ấy là bạn cùng lớp của_tôi
can i return the chudidhar if it doesn't fit	tôi có_thể trả lại chudidhar nếu nó không phù_hợp
she will look so beautiful in white, yeah yeah	cô_ấy sẽ trông rất đẹp màu trắng , vâng
when do you go to bed	khi nào bạn đi ngủ
why is the train delayed	tại_sao tàu bị trì_hoãn
and the fears that once controlled me can not get to me at all	và những nỗi sợ_hãi mà một_khi đã kiểm_soát tôi không_thể đến với tôi
please come	hãy đến
what is his name	tên của anh_ấy là_gì
is he regular to the classes	anh_ấy có thường_xuyên với các lớp_học không
where is your warehouse	nhà_kho của_bạn ở_đâu
ask that man not to shout	yêu_cầu người đàn_ông đó đừng hét lên
where did he study earlier	anh_ấy đã học ở_đâu trước đó
did he come here yesterday	có phải anh_ấy đã đến đây ngày hôm_qua
are you joking	bạn đang nói đùa
she is my grandmother	cô_ấy là bà của_tôi
i did not ask you to wait for me	tôi đã không yêu_cầu bạn đợi tôi
it is already 8.30. i don't think they will come	nó đã là 8,30 . tôi không nghĩ rằng họ sẽ đến
i like people who work hard	tôi thích những người làm_việc chăm_chỉ
fighting against all odds	chiến_đấu chống lại tất_cả các tỷ_lệ_cược
get dressed quickly	mặc quần_áo nhanh_chóng
your number please	xin vui_lòng số của_bạn
may i have a word with you, sir	tôi có_thể có một lời với bạn, thưa ông
thank you for attending the party	cảm_ơn bạn đã tham_dự bữa tiệc
can i have a different color	tôi có_thể có một màu_khác không
he is on leave	anh_ấy đang nghỉ_phép
can i have a refill, please	tôi có_thể nạp tiền không
be my girl, i will be your man	là cô_gái của tôi , tôi sẽ là người đàn_ông của bạn
india is never busy during autumn	ấn_độ_không bao_giờ bận_rộn trong mùa_thu
i am mary	tôi là mary
dad, do you have office tomorrow	bố, bạn có văn_phòng vào ngày_mai không
what is your favorite fashion brand	thương hiệu thời_trang yêu_thích của_bạn là_gì
turn away and slam the door	quay đi và đóng sầm cửa
listen to me	lắng_nghe tôi
can i have a different type of seafood, please	tôi có_thể có một loại hải_sản khác không
the united states is usually chilly during july	hoa_kỳ thường lạnh trong tháng_bảy
so as long as i live i love you	vì_vậy , miễn_là tôi sống , tôi yêu bạn
sir i have five years of experience in editing	thưa ông, tôi có năm năm kinh_nghiệm chỉnh sửa
paris is never relaxing during march	paris không_bao_giờ thư_giãn trong tháng_ba
how do i get to the nearest tourist attraction	làm_cách_nào để đến điểm thu_hút khách du_lịch gần nhất
can i have a different type of sauce, please	tôi có_thể có một loại nước sốt khác nhau được không
which is your bag	cái túi của_bạn là_gì
finds love like you and i did	tìm thấy tình_yêu như bạn và tôi đã làm
when does it land at mumbai	khi nào nó hạ_cánh tại mumbai
what is your favorite animal	động_vật yêu_thích của_bạn là_gì
paris is never busy during summer	paris không_bao_giờ bận_rộn trong mùa_hè
sir, i am a paper supplier. it seems you wanted some papers. whom should i meet in this connection	thưa ông, tôi là nhà cung_cấp giấy . có_vẻ như bạn muốn một_số giấy_tờ . tôi nên gặp ai trong kết_nối này
can you recommend a good restaurant	bạn có_thể giới_thiệu một nhà_hàng tốt
i don't have a good appetite	tôi không có sự thèm ăn tốt
could i speak to mr. johnson	tôi có_thể nói_chuyện với ông johnson không
what is the major occupation of the people there	nghề_nghiệp chính của người dân ở đó là_gì
return it safely	trả lại nó một_cách an_toàn
how do i get to the neares	làm_cách_nào để đến gần nhấ
don't keep the door open	đừng giữ cửa_mở
what is your favorite book genre	thể_loại cuốn sách yêu_thích của_bạn là_gì
where do they want you to come	họ muốn bạn đến đâu
and you let her go	và bạn để cô_ấy đi
we dislike grapefruit	chúng_tôi không thích bưởi
is he at home	anh_ta co ở nha không
how about you	còn bạn thì sao
i am in love with your body	tôi yêu cơ_thể của bạn
how long are you going to stay there	bạn sẽ ở lại đó trong bao_lâu
last week i deposited a cheque. has the amount been credited to my account	tuần trước tôi đã gửi một tấm séc . số tiền đã được ghi có vào tài_khoản của_tôi chưa
i have a car	tôi có một chiếc xe_hơi
what time does the brindavan express leave	mấy giờ brindavan_express rời đi
i leave at 9.15	tôi rời đi lúc 9,15
are you going with them	bạn đang đi với họ
please hold on	xin hãy giữ
are you aware of that	bạn có biết rằng
new jersey is busy during spring	new_jersey đang bận_rộn trong mùa_xuân
what is your favorite season	mùa_yêu_thích của_bạn là_gì
how is everybody at home	mọi người ở nhà thế_nào
are they your relatives	họ có phải là người_thân của_bạn không
i feel happy	tôi cảm_thấy hạnh_phúc
are you angry with me	bạn có giận tôi không
i am leaving for salem tomorrow night	tôi sẽ đi salem vào tối mai
any message please	xin vui_lòng tin nhắn
who are you to command me	bạn là ai chỉ_huy tôi
what do you think of him	bạn nghĩ gì về anh_ta
she is driving the old yellow truck 	cô_ấy đang lái chiếc xe_tải màu_vàng cũ
why are you asking me	tại_sao bạn lại hỏi tôi
the water is soft	nước_mềm
fill up your bag and i fill up a plate	đổ_đầy túi của bạn và tôi đổ_đầy một cái đĩa
the peach is your most loved fruit	đào là trái_cây được yêu_thích nhất của bạn
she is my mother	cô_ấy là mẹ tôi
may i know who is calling	tôi có_thể biết ai đang gọi không
i will not give you up this time	tôi sẽ không từ bỏ bạn lần này
where did you go on vacation	bạn đã đi đâu trong kỳ nghỉ
i have no office today	tôi không có văn_phòng hôm_nay
sorry i am late. i missed the bus	xin_lỗi tôi đến muộn . tôi đã bỏ lỡ xe_buýt
i wait for him at the station	tôi đợi anh_ta ở nhà_ga
how far is salem from here	salem từ đây bao_xa
did i ask you	tôi đã hỏi bạn chưa
everybody makes mistakes sometimes you know	mọi người đều mắc_lỗi đôi_khi bạn biết
may i know your number please	tôi có_thể biết số của_bạn được không
is she calling you	cô_ấy đang gọi cho bạn
i feel powerful	tôi cảm_thấy mạnh_mẽ
bear in mind	hãy ghi_nhớ trong tâm_trí
do you have any doubt	bạn có nghi_ngờ gì không
can you speak slower, please	bạn có_thể nói chậm hơn được không
are you free now	bây_giờ bạn có rảnh không
how will you manage	bạn sẽ quản_lý như thế_nào
please connect me to extension 2434	vui_lòng kết_nối tôi với phần mở_rộng 2434
that perfect girl is gone	cô_gái hoàn_hảo đó đã biến mất
when did he come	anh_ấy đến khi nào
i will ask him to get you something to eat	tôi sẽ yêu_cầu anh_ấy lấy cho bạn một cái_gì đó để ăn
in that very moment	trong chính khoảnh_khắc đó
how is your mother	mẹ của_bạn thế_nào
would you mind closing the window	bạn có phiền khi đóng cửa_sổ không
where do you look for him	bạn tìm anh_ấy ở_đâu
i’m hungry. do you want to eat something	tôi đói . bạn co muôn ăn thư gi đo không
could i meet the class teacher	tôi có_thể gặp giáo_viên lớp không
what is your favorite historical landmark	cột_mốc lịch_sử yêu_thích của_bạn là_gì
only hate the road when you are missing home	chỉ ghét con đường khi bạn mất_tích ở nhà
thank you	cảm_ơn
yes. you can	đúng . bạn có_thể
is she writing a letter	cô_ấy đang viết một lá thư
paris is usually snowy during winter	paris thường tuyết rơi trong mùa_đông
hey….. how dare you talk to me like that	này …_.. làm thế_nào bạn dám nói_chuyện với tôi như vậy
is gayathri waiting for you	gayathri có chờ_đợi bạn không
sir, do you have any extra tickets	thưa ông, ông có thêm vé không
we are two brothers and a sister at home	chúng_tôi là hai anh_em và một chị gái ở nhà
what is your favorite place to visit	nơi yêu_thích của_bạn để ghé thăm là_gì
what is the minimum amount to be deposited to open an account	số tiền tối_thiểu được gửi để mở tài_khoản là bao_nhiêu
i have college today	tôi có đại_học hôm_nay
do you have any recommendations for art galleries	bạn có bất_kỳ đề_xuất cho các phòng trưng_bày nghệ_thuật
send him out	gửi anh_ta ra
what is your favorite sport	môn thể_thao yêu_thích của_bạn là_gì
doctor, i have a severe headache	bác_sĩ, tôi bị đau_đầu dữ_dội
i am doing business	tôi đang kinh_doanh
i have to take her to kumbakonam	tôi phải đưa cô_ấy đến kumbakonam
california is usually quiet during march	california thường im_lặng trong tháng_ba
i like reading books	tôi thích đọc sách
do you have any recommendations for historical tours	bạn có bất_kỳ đề_xuất cho các tour du_lịch lịch_sử
when are you going to get married	khi nào bạn sẽ kết_hôn
what do you do	bạn làm nghề gì
what is your favorite type of wine	loại rượu_vang yêu_thích của_bạn là_gì
where do i collect my baggage	tôi thu_thập hành_lý của mình ở_đâu
do you have metal chiffon saree	bạn có saree bằng kim_loại không
he is a business man	anh_ấy là một doanh_nhân
excuse me. do you have a spare ticket	xin_lỗi . bạn có một vé dự_phòng
don't ask me anything	đừng hỏi tôi bất_cứ điều gì
remind me	nhắc_nhở tôi
sir, can i go home early today? i have some guests at home	thưa ông, hôm_nay tôi có_thể về nhà sớm không ? tôi có một_số khách ở nhà
i don't like sitting idle	tôi không thích ngồi nhàn_rỗi
ask him to bring the files	yêu_cầu anh_ta mang theo các tập tin
i was bird	tôi là chim
what is your favorite type of dance	kiểu khiêu_vũ yêu_thích của_bạn là_gì
i am sorry, i am late	tôi xin_lỗi, tôi đến muộn
it is okay	không_sao đâu
lock the door	khóa cửa
france is wonderful during november	pháp thật tuyệt_vời trong tháng_11
it is funny how some distance makes everything seem small	thật buồn_cười khi một khoảng_cách nào đó làm cho mọi thứ dường_như nhỏ
i am sorry, i did not mean to offend you	tôi xin_lỗi, tôi không có ý xúc_phạm bạn
where is your brother now	anh_trai của_bạn bây_giờ ở_đâu
how do i book a hotel room	làm_cách_nào để đặt phòng khách_sạn
i am a professor of english in university of wisconsin	tôi là giáo_sư tiếng anh_ấytại đại_học wisconsin
how do i get to the nearest zoo	làm_cách_nào để đến sở_thú gần nhất
what are your working hours	giờ làm_việc của_bạn là_gì
i read the times	tôi đọc những lần
whatever is destined to happen, will happen	bất_cứ điều gì được định_mệnh xảy ra, sẽ xảy ra
is your office fully computerised	văn_phòng của_bạn có được vi_tính hóa đầy_đủ không
was i appointed	tôi đã được bổ_nhiệm
i am looking for a gift, may be a doll within usd $ 20	tôi đang tìm_kiếm một món quà, có_thể là một con_búp_bê trong vòng 20 usd
i need a doctor	tôi cần bác_sĩ
china is usually dry during march	trung_quốc thường khô trong tháng_3
i am a b.sc., graduate	tôi là một b.sc., tốt_nghiệp
so the bar is where i go	vì_vậy , thanh là nơi tôi đến
could you wake me up if you are awake	bạn có_thể đánh_thức tôi nếu bạn thức
which one do you want	bạn muốn cái nào
i have no problem	tôi không có vấn_đề gì
staring at the ceiling in the dark	nhìn chằm_chằm lên trần nhà trong bóng_tối
are the shops open	các cửa_hàng có mở không
please do	vui_lòng làm
paris is usually freezing during october	paris thường bị đóng_băng trong tháng_10
do you have any recommendations for family-friendly activities	bạn có bất_kỳ khuyến_nghị cho các hoạt_động thân_thiện với gia_đình
can i try this on	tôi có_thể thử cái này trên không
i did my college studies in washington	tôi đã học đại_học ở washington
where do you come from	bạn đến từ đâu
i keep my books here	tôi giữ sách của_tôi ở đây
ours is a joint family	chúng_tôi là một gia_đình chung
where can i find a taxi	tôi có_thể tìm thấy một chiếc taxi ở_đâu
is he running	anh_ấy đang chạy đúng không
india is rainy during june	ấn_độ mưa trong tháng_6
did he borrow a pen	anh_ấy đã mượn một cây bút
oh, oh, mm, oh	oh , oh , mm , oh
does mr. pandian coming from k.k. nagar work here	ông pandian đến từ k.k.nagar làm_việc ở đây
my native town is chicago	thị_trấn quê_hương của_tôi là chicago
do you have any recommendations for local cuisine	bạn có bất_kỳ khuyến_nghị cho ẩm_thực_địa_phương
it might rain today	nó có_thể mưa hôm_nay
i am sorry i am late	tôi xin_lỗi tôi đến muộn
i don't like your telling lies	tôi không thích những lời_nói_dối của_bạn
what is your favorite type of fish	loại cá yêu_thích của_bạn là_gì
can i have a different flavor	tôi có_thể có một hương_vị khác nhau không
what day is today	hôm_nay là ngày gì
china is warm during spring	trung_quốc ấm_áp trong mùa_xuân
sorry. you can not	lấy làm tiếc . bạn không_thể
i have a scooter	tôi có một chiếc xe_tay ga
who will help you	ai sẽ giúp bạn
does the school work this saturday	trường_học có làm_việc vào thứ_bảy này không
where is the nearest atm	atm gần nhất ở_đâu
india is never snowy during september	ấn_độ_không bao_giờ có tuyết trong tháng_chín
your heart is all i own	trái_tim của bạn là tất_cả những gì tôi sở_hữu
i am frank	tôi thẳng_thắn
you have no experience at all. how do you expect us to give you the job	bạn không có kinh_nghiệm nào cả . làm thế_nào để bạn mong_đợi chúng_tôi cung_cấp cho bạn công_việc
sir, mr arunkumar called	thưa ông, ông arunkumar gọi
we like peaches	chúng_tôi thích đào
it was kind of you to have invited me	đó là loại bạn đã mời tôi
i am saravanan calling from singapore. would you please call mr. raja your neighbour	tôi đang gọi saravanan từ singapore . bạn có_thể gọi ông raja là hàng_xóm của_bạn không
which game do you like? cricket or tennis	bạn thích trò_chơi nào ?_dế hoặc quần_vợt
here is the bill	đây là hóa đơn
i am never going back, the past is in the past	tôi không bao_giờ quay lại , quá_khứ là quá_khứ
very expensive	rất đắt
how did they escape	làm thế_nào mà họ trốn thoát
when you said you looked a mess	khi bạn nói rằng bạn trông có_vẻ lộn_xộn
how is your brother	anh_trai của_bạn thế_nào
i have bird	tôi có chim
how is life	cuộc_sống thế_nào
my teacher has asked me to bring all the books today	giáo_viên của_tôi đã yêu_cầu tôi mang tất_cả các cuốn sách ngày hôm_nay
does the boy arise	cậu bé có phát_sinh không
tonight	tối nay
that is ok	được thôi
what is your favorite type of butterfly	loại bướm yêu_thích của_bạn là_gì
yes, sir. i have been working in microsoft for the last seven years	vâng thưa ngài . tôi đã làm_việc tại microsoft trong bảy năm qua
it is always sunny there	trời luôn nắng ở đó
i did my school education in chicago	tôi đã học ở trường_học ở chicago
ravi came here yesterday. he said that he would be leaving for madurai this monday	ravi đã đến đây ngày hôm_qua . anh_ấy nói rằng anh_ấy sẽ rời madurai vào thứ_hai tuần này
they want me to come to madurai	họ muốn tôi đến madurai
china is usually mild during winter	trung_quốc thường ôn_hòa trong mùa_đông
what is your favorite historical site	trang web lịch_sử yêu_thích của_bạn là_gì
can i have a smaller size	tôi có_thể có kích_thước nhỏ hơn không
i get up at 6.30	tôi thức dậy lúc 6 h30
may i know your name	tôi có_thể biết tên của_bạn không
what will you do	bạn sẽ làm gì
did he attempt	anh_ấy đã cố_gắng
i don't feel like eating anything	tôi không cảm_thấy muốn ăn bất_cứ thứ gì
i have two brothers and a sister	tôi có hai anh_trai và một em_gái
can you show me on the map	bạn có_thể cho tôi xem trên bản_đồ không
we have a maruthi car	chúng_tôi có một chiếc_xe maruti
do you have a school bus	bạn có xe_buýt trường_học không
she likes peaches	cô_ấy thích đào
where is the reservation counter	bộ đếm đặt phòng ở_đâu
i should not have wasted my time	tôi không nên lãng_phí thời_gian của mình
i am free	tôi rảnh
when will they come	khi nào họ sẽ đến
does he advantage a lot	anh_ấy có lợi_thế rất nhiều không
are you familiar with dtp and multimedia	bạn có quen_thuộc với dtp và đa_phương_tiện không
i like grapes	tôi thích nho
he is my father	ông là cha của_tôi
what is your favorite color	màu_sắc ưa_thích của_bạn là_gì
me and my friends at the table doing shots	tôi và bạn_bè của tôi ở bàn làm_việc
the united states is sometimes mild during june	hoa_kỳ đôi_khi ôn_hòa trong tháng_6
how do i get to the nearest park	làm_cách_nào để đến công_viên gần nhất
has the brindavan arrived	brindavan đã đến chưa
i know her in april	tôi biết cô_ấy vào tháng_tư
and i will rise like the break of dawn	và tôi sẽ vươn lên như giờ_nghỉ bình_minh
is he buying fruits	anh_ấy đang mua trái_cây
i’m surprised. you gave me a gift	tôi ngạc_nhiên . bạn đã tặng tôi một món quà
did you receive my letter	bạn đã nhận được lá thư của_tôi
your most loved animals are horses 	những con_vật được yêu_thích nhất của bạn là ngựa
what is your favorite type of art	loại_hình nghệ_thuật yêu_thích của_bạn là_gì
you like pears	bạn thích lê
elephants were his most feared animals 	voi là những con_vật đáng sợ nhất của anh_ta
sir, this is not new to me and i have three years of experience in this field	thưa ông, điều này không_phải là mới đối_với tôi và tôi có ba năm kinh_nghiệm trong lĩnh_vực này
can i have a different genre of music, please	tôi có_thể có một_thể_loại âm_nhạc khác nhau được không
does the enemy bowl him	kẻ_thù có bát anh_ta không
what is your favorite historical period	thời_kỳ lịch_sử yêu_thích của_bạn là_gì
china is usually pleasant during november	trung_quốc thường dễ_chịu trong tháng_11
what is the best time to visit	thời_gian tốt nhất để ghé thăm là_gì
i belong to chicago	tôi thuộc về chicago
is he giving the book	anh_ấy đang đưa cuốn sách
france is usually quiet during november	pháp thường im_lặng trong tháng_11
what are you	bạn là_gì
india is usually quiet during fall	ấn_độ thường im_lặng trong mùa_thu
is it your first visit to chennai	đây có phải là chuyến thăm đầu_tiên của_bạn đến chennai
only miss the sun when it starts to snow	chỉ bỏ lỡ mặt_trời khi trời bắt_đầu tuyết
it is quite tasty	nó khá ngon
does the dog bite	con_chó có cắn không
sujatha has school tomorrow	sujatha có trường_học vào ngày_mai
i am fine and you	tôi ổn và bạn
please put me to extension 2434	vui_lòng đặt tôi để mở_rộng 2434
you like grapes	bạn thích nho
does he complain	anh_ấy có phàn_nàn không
he has bird	anh_ấy có chim
don't spend all the money	đừng tiêu hết tiền
paris is usually chilly during fall	paris thường lạnh trong mùa_thu
what is your favorite fashion designer	nhà thiết_kế thời_trang yêu_thích của_bạn là_gì
i have come to enquire about my son's performance in the class. how is he doing	tôi đã đến để hỏi về hiệu_suất của con_trai tôi trong lớp . anh_ấy đang làm như thế_nào
baby, i am dancing in the dark	em_yêu , tôi đang nhảy trong bóng_tối
i am very strict	tôi rất nghiêm_khắc
get up	thức dậy
where can i collect the material	tôi có_thể thu_thập tài_liệu ở_đâu
the house is beautiful	ngôi_nhà đẹp
the orange is his least favorite fruit	màu_cam là trái_cây ít yêu_thích nhất của anh_ấy
the united states is never wet during january	hoa_kỳ không_bao_giờ bị ướt trong tháng_1
i will handover some of my stuff to my friend. i will be back	tôi sẽ bàn_giao một_số thứ của_tôi cho bạn của_tôi . tôi sẽ trở_lại
i have studied unto graduation	tôi đã học để tốt_nghiệp
where is his residence	nơi cư_trú của anh_ấy ở_đâu
we like oranges	chúng_tôi thích cam
is it welcome group of companies	nó có phải là nhóm các công_ty chào_đón
i have office tomorrow	tôi có văn_phòng vào ngày_mai
france is never cold during september	pháp không_bao_giờ lạnh trong tháng_9
is your mother preparing food	mẹ của_bạn có chuẩn_bị thức_ăn không
how do i get to the nearest subway station	làm_cách_nào để đến ga tàu_điện_ngầm gần nhất
can i have a refill of water, please	tôi có_thể nạp nước được không
i am an engineer	tôi là một kỹ_sư
france is never chilly during march	pháp không_bao_giờ lạnh_lẽo trong tháng_3
sir, please get me a ticket to gandhi nagar	thưa ông, xin vui_lòng cho tôi một vé đến gandhi_nagar
how do i get to the nearest supermarket	làm_cách_nào để đến siêu_thị gần nhất
india is usually pleasant during november	ấn_độ thường dễ_chịu trong tháng_11
how many rooms are there in that house	có bao_nhiêu phòng trong ngôi_nhà đó
you have been a great help. thank you very much	bạn đã giúp_đỡ rất nhiều . cảm_ơn rất nhiều
okay, come to the point	được rồi, hãy đến điểm
china is never mild during april	trung_quốc không_bao_giờ ôn_hòa trong tháng_tư
what is your favorite type of seafood	loại hải_sản yêu_thích của_bạn là_gì
she is my younger sister	cô_ấy là em_gái của_tôi
can i have a receipt, please	tôi có_thể có một nhận xin vui_lòng
can i speak to mr. sultan	tôi có_thể nói_chuyện với ông sultan không
he is working in msn – usa	anh_ấy đang làm_việc trong msn - hoa_kỳ
paris is pleasant during december	paris rất dễ_chịu trong tháng_12
sir, could i park my scooter here	thưa ông, tôi có_thể đỗ xe tay ga của mình ở đây không
you ask sita to wait in her office	bạn yêu_cầu sita đợi trong văn_phòng của cô_ấy
darling, you look perfect tonight	em_yêu , bạn trông thật hoàn_hảo tối nay
there is no need to worry	không cần phải lo_lắng
yes, speaking	vâng, noi đi
he came to my office	anh_ấy đến văn_phòng của_tôi
can you recommend a good hotel	bạn có_thể giới_thiệu một khách_sạn tốt
i am a graduate in commerce	tôi tốt_nghiệp thương_mại
i am from chicago	tôi đến từ chicago
do you have time to read the paper in the morning	bạn có thời_gian để đọc tờ giấy vào buổi sáng không
it was a nice evening	đó là một buổi tối tốt_đẹp
i have mouth sores	tôi bị loét miệng
i like watching t.v	tôi thích xem tv
i have a bad cold	tôi bị cảm_lạnh
don't cry	đừng khóc
very nice to have you here	rất vui khi có bạn ở đây
mind your tongue	tâm_trí lưỡi của_bạn
how many siblings do you have	bạn có bao_nhiêu anh_chị_em ruột
is the bus corning	xe_buýt có phải là corning không
mind the steps	nhớ các bước
i don't like watching the t.v. serials	tôi không thích xem các sê - ri t.v
same old empty feeling in your heart	cùng một cảm_giác trống_rỗng trong trái_tim bạn
paris is sometimes pleasant during autumn	paris đôi_khi dễ_chịu trong mùa_thu
my sister is very innocent	em_gái tôi rất ngây_thơ
can i have a replacement	tôi có_thể thay_thế không
is he your relative	anh_ấy có phải là người_thân của_bạn không
where do they live	họ sống ở_đâu
excuse me madam, may i come in	xin_lỗi, thưa bà, tôi có_thể vào không
where is the ticket counter	bộ đếm vé ở_đâu
he is fine	anh_ấy ổn
i hope they will win	tôi hy_vọng họ sẽ thắng
and in your eyes, you are holding mine	và trong mắt bạn , bạn đang giữ của tôi
did he come	anh_ấy đã đến
i will ask them to wait	tôi sẽ yêu_cầu họ chờ_đợi
did i bargain with the vendor	tôi đã mặc_cả với nhà cung_cấp
i like people who speak the truth	tôi thích những người nói sự_thật
they like lemons	họ thích chanh
what all buses go to gandhi nagar	tất_cả những gì xe_buýt đi đến gandhi_nagar
if you had called me, i would have come there	nếu bạn đã gọi cho tôi, tôi sẽ đến đó
what is your father	cha của_bạn là_gì
the strawberry is his least favorite fruit	dâu là trái_cây ít yêu_thích nhất của anh_ấy
(oh-i-oh-i-oh-i-oh-i)	( oh-i-oh-i-oh-ih-oh-i )
is it raining	trời đang mưa
france is sometimes rainy during february	pháp đôi_khi mưa trong tháng_hai
i will ask her to cook today	tôi sẽ yêu_cầu cô_ấy nấu_ăn hôm_nay
ours is a large family	chúng_ta là một gia_đình lớn
call them in	gọi họ vào
staring at the bottom of your glass	nhìn chằm_chằm ở dưới cùng của kính của bạn
i would like to buy a doll within usd $ 20	tôi muốn mua một con_búp_bê trong vòng 20 usd
how did he come	làm thế_nào mà anh_ấy đến
i don't feel like walking fast	tôi không cảm_thấy muốn đi bộ nhanh
'cause you loved her too much, and you dived too deep	vì bạn yêu cô_ấy quá nhiều , và bạn đã lặn quá sâu
what are you going to do next	bạn sẽ làm gì tiếp_theo
when are you going to vacate the house	khi nào bạn sẽ rời khỏi nhà
how do i get to the nearest airport	làm_cách_nào để đến sân_bay gần nhất
the worst possible situation	tình_huống tồi_tệ nhất có_thể
i will ask ramesh to reserve two tickets	tôi sẽ yêu_cầu ramesh đặt trước hai vé
are they coming here tomorrow	họ có đến đây vào ngày_mai không
she likes lemons	cô_ấy thích chanh
i like grapefruit	tôi thích bưởi
does this bus go to gandhi nagar	xe_buýt này có đi đến gandhi_nagar không
the house is big	căn nhà thì to
read them aloud	đọc to chúng
i am one with the wind and sky	tôi là một người có gió và bầu_trời
why did you resign the job	tại_sao bạn đã từ_chức công_việc
can i have a different flavor of ice cream, please	tôi có_thể có một hương_vị khác của kem được không
do you have any recommendations for art museums	bạn có bất_kỳ khuyến_nghị cho bảo_tàng nghệ_thuật
you could have come by auto	bạn có_thể đã đến bằng ô_tô
i feel giddy	tôi cảm_thấy ham chơi
can i borrow your pen	tôi có_thể mượn bút của_bạn không
get out of my sight	hãy ra khỏi tầm_mắt của_tôi
the grapefruit is her least favorite fruit	bưởi là trái_cây yêu_thích nhất của cô_ấy
normally, i have tea in the morning	thông_thường, tôi có trà vào buổi sáng
i have a meeting today	tôi có một cuộc họp hôm_nay
what are you doing	bạn đang làm gì thế
what is your phone number	số điện_thoại của_bạn là_gì
what do you have in the morning? coffee or tea	bạn có gì vào buổi sáng ? cà_phê hay trà
india is sometimes cold during march	ấn_độ đôi_khi lạnh trong tháng_3
are you letting out your house	bạn đang cho ra khỏi nhà của_bạn
you like lemons	bạn thích chanh
pretty well	khá tốt
did you go to office yesterday	bạn đã đến văn_phòng ngày hôm_qua
who called you	ai gọi bạn
she disliked a rusty yellow car 	cô_ấy không thích một chiếc_xe màu_vàng gỉ
i would like to meet the class teacher	tôi muốn gặp giáo_viên lớp
who is that man standing over there	người đàn_ông đó đứng ở đó là ai
where can i find a post office	tôi có_thể tìm một bưu_điện ở_đâu
that is okay. it sometimes happens like that	vậy được rồi . nó đôi_khi xảy ra như vậy
do you have any recommendations for scenic train rides	bạn có bất_kỳ đề_xuất cho các chuyến tàu tuyệt đẹp
is he learning english	anh_ấy đang học tiếng anh
are you married	bạn kết_hôn rồi phải không
is the seat vacant	chỗ ngồi có bỏ trống không
i know we'll be alright this time	tôi biết rõ là ổn lần này
what is he	anh_ta là_gì
only know you have been high when you are feeling low	chỉ biết bạn đã cao khi bạn cảm_thấy thấp
what is your opinion	ý_kiến ​_​ của_bạn là_gì
what is your favorite type of fruit	loại trái_cây yêu_thích của_bạn là_gì
sir, i am basically a science graduate, but am working as an accountant and the job is not to my taste, so i am looking for a new job	thưa ông, tôi về cơ_bản là một sinh_viên tốt_nghiệp khoa_học, nhưng tôi đang làm kế_toán và công_việc không_phải là sở_thích của_tôi, vì_vậy tôi đang tìm_kiếm một công_việc mới
can i leave my bag here	tôi có_thể để túi của_tôi ở đây không
i will ask him to call you u	tôi sẽ yêu_cầu anh_ấy gọi cho bạ
don't think that you are clever	đừng nghĩ rằng bạn thông_minh
why not with the help of this site	tại_sao không với sự giúp_đỡ của trang_web này
ours is a large joint family	chúng_tôi là một gia_đình chung lớn
india is usually dry during april	ấn_độ thường khô trong tháng_tư
why are you shouting like this	tại_sao bạn lại hét lên như thế này
when are you moving to the new house	khi nào bạn chuyển đến ngôi_nhà mới
how much should i pay	tôi nên trả bao_nhiêu
shall i ask mrs. geetha to use the cd instead of floppy	tôi có nên yêu_cầu bà geetha sử_dụng cd thay_vì mềm không
go to hell	đi chết đi
india is never chilly during october	ấn_độ không_bao_giờ lạnh_lẽo trong tháng_10
fantastic	tuyệt_vời
do you speak english	bạn có nói tiếng anh_ấy không
go to sleep	đi ngủ
what is your favorite festival	lễ_hội yêu_thích của_bạn là_gì
wait for sometime	đợi một thời_gian
did she appeal	cô_ấy đã kháng_cáo
whose handwriting is this	chữ_viết tay của ai là của ai
did he say anything	anh_ấy có nói gì không
chennai is 2000km from mumbai	chennai cách mumbai_2000 km
no problem	không có gì
the cold never bothered me anyway	cái lạnh không bao_giờ làm_phiền tôi dù_sao
he is out of town	anh_ấy ra khỏi thị_trấn
our least liked fruit is the lemon	trái_cây ít thích nhất của chúng_tôi là chanh
what is your favorite type of insect	loại côn_trùng yêu_thích của_bạn là_gì
no, not at all	không hoàn_toàn không
is there any browsing centre close by	có trung_tâm duyệt nào gần đó không
in	vào
i am a student of uit	tôi là một sinh_viên của uit
i buy my dresses in t.nagar	tôi mua váy của_tôi ở t.nagar
california is never hot during fall	california không_bao_giờ nóng trong mùa_thu
your tuition miss called. she said that there would be no class tomorrow	học_phí của_bạn bỏ lỡ được gọi_là . cô_ấy nói rằng sẽ không có lớp_học vào ngày_mai
fine	khỏe
i have asked you several times not to keep anything on the t.v., but you never listen to me	tôi đã yêu_cầu bạn nhiều lần không giữ bất_cứ điều gì trên t.v., nhưng bạn không_bao_giờ lắng_nghe tôi
is it number 17	nó có phải là số 17 không
conductor, you have not paid the balance. i am to get down at the next stop	nhạc_trưởng, bạn đã không trả số_dư . tôi sẽ xuống tại điểm dừng tiếp_theo
how are you	bạn có khỏe không
don't mention it	không đề_cập đến nó
who told you	ai nói với bạn
is it prasad's residence	có phải là nơi cư_trú của prasads không
fit as a fiddle	lắp vào cho vừa
how far is it from mumbai	nó cách mumbai bao_xa
i don't know why they have come	tôi không biết tại_sao họ lại đến
how do you know that	làm_sao bạn biết điều đó
is it a copy righted cd	nó có phải là một cd có bản_quyền
can i have a different size, please	tôi có_thể có một kích_thước khác nhau được không
what is your favorite fashion trend	xu_hướng thời_trang yêu_thích của_bạn là_gì
does the bomb blast	liệu vụ nổ bom có phải không
did you understand this lesson	bạn đã hiểu bài_học này
why fear when i am here	tại_sao phải sợ khi tôi ở đây
we are six people at home. my father, my mother, my two sisters and a brother besides myself	chúng_tôi là sáu người ở nhà . bố tôi, mẹ tôi, hai chị_gái và một anh_trai bên cạnh tôi
where can i buy tickets	tôi có_thể mua vé ở_đâu
do you have any recommendations for scenic hiking trails	bạn có bất_kỳ đề_xuất cho những con_đường_mòn đi bộ đường dài đẹp
they will not listen to me	họ sẽ không lắng_nghe tôi
i come from chicago	tôi đến từ chicago
how do i get to the nearest pharmacy	làm_cách_nào để đến nhà_thuốc gần nhất
i have a lot of friends here	tôi có rất nhiều bạn ở đây
india is snowy during spring	ấn_độ có tuyết trong mùa_xuân
it is time to see what i can do	đã đến lúc xem tôi có_thể làm gì
what type of person are you	bạn thuộc mẫu người nào
how do i get to the nearest restaurant	làm_cách_nào để đến nhà_hàng gần nhất
i have two brothers	tôi có hai anh_em
can i keep this with me as hand baggage	tôi có_thể giữ cái này với tôi như hành_lý tay không
can you suggest a nice gift for a two year old female child	bạn có_thể gợi_ý một món quà đẹp cho một đứa trẻ hai tuổi không
does this bus go via ashok nagar	xe_buýt này có đi qua ashok_nagar không
i don't like your going there	tôi không thích bạn đến đó
i whispered underneath my breath	tôi thì_thầm bên dưới hơi thở của mình
it is very hot inside. can i open the windows	nó rất nóng bên trong . tôi có_thể mở cửa_sổ không
do you have any recommendations for shopping	bạn có bất_kỳ khuyến_nghị để mua_sắm
you like limes	bạn thích chanh
i’m feeling sick. can you take me to the doctor	tôi cảm_thấy bị bệnh . bạn có_thể đưa tôi đến bác_sĩ
paris is warm during january	paris ấm_áp trong tháng_1
he studied in bharathiar school, chennai	ông học tại trường bharathiar, chennai
can i have a different style of dance, please	tôi có_thể có một phong_cách khiêu_vũ khác nhau được không
how do i get to the nearest shopping mall	làm_cách_nào để đến trung_tâm mua_sắm gần nhất
did i give you the balance	tôi đã cho bạn sự cân_bằng
the united states is sometimes rainy during winter	hoa_kỳ đôi_khi mưa trong mùa_đông
there was a call from vasanthi. she said that her mother-in-law had come, so she would not be coming to temple tomorrow	có một cuộc gọi từ vasanthi . cô_ấy nói rằng mẹ chồng của cô_ấy đã đến, vì_vậy cô_ấy sẽ không đến temple vào ngày_mai
does he bathe in hot water	anh_ấy có tắm trong nước nóng không
how do i get to the nearest bus stop	làm_cách_nào để đến trạm xe_buýt gần nhất
does he beat me	anh_ấy có đánh_bại tôi không
daddy, somebody came from your office. he said that he wanted to talk to you something important	bố ơi, ai đó đến từ văn_phòng của_bạn . anh_ấy nói rằng anh_ấy muốn nói_chuyện với bạn điều gì đó quan_trọng
how is your father	bố bạn thế_nào
the house is lovely	ngôi_nhà thật đáng yêu
where is your residence	nơi cư_trú của_bạn ở_đâu
how do you find the course	làm thế_nào để bạn tìm thấy khóa học
i am mrs. clinton	tôi là bà clinton
i like playing cricket	tôi thích chơi cricket
paris is usually wet during august	paris thường ướt trong tháng_8
she is bird	cô_ấy là chim
california is never cold during december	california không_bao_giờ lạnh trong tháng_12
my friend ravi has a scooter	bạn tôi ravi có một chiếc xe_tay ga
what is your favorite historical battle	trận_chiến lịch_sử yêu_thích của_bạn là_gì
but you only need the light when it is burning low	nhưng bạn chỉ cần ánh_sáng khi nó đang cháy thấp
do you have any recommendations for water activities	bạn có bất_kỳ khuyến_nghị cho các hoạt_động nước
i am working in microsoft corporation	tôi đang làm_việc trong microsoft_corporation
it doesn't matter, but don't make it a habit	nó không quan_trọng, nhưng đừng làm cho nó một thói_quen
and then we start to dance, and now i am singing like	và sau đó chúng_ta bắt_đầu nhảy , và bây_giờ tôi đang hát như
sir, would you mind keeping this bag under the seat	thưa ông, bạn có phiền giữ chiếc túi này dưới chỗ ngồi không
what is your hobby	sở_thích của_bạn là_gì
new jersey is usually freezing during november	new_jersey thường bị đóng_băng trong tháng_11
i may be crazy, don't mind me	tôi có_thể điên , đừng bận_tâm tôi
how do i get to the nearest amusement park	làm_cách_nào để đến công_viên giải_trí gần nhất
sir. mr. gupta called	quý ngài . ông gupta gọi
where are you now	bạn đang ở chỗ nào
i belong to chennai	tôi thuộc về chennai
through thick and thin i will stand by you	qua dày và mỏng, tôi sẽ đứng bên cạnh bạn
california is usually pleasant during september	california thường dễ_chịu trong tháng_9
is computer an advanced technology	máy_tính có phải là một công_nghệ tiên_tiến
what is your favorite type of cuisine	loại ẩm_thực yêu_thích của_bạn là_gì
could you tell us something about yourself	bạn có_thể cho chúng_tôi biết điều gì đó về bản_thân bạn
do the home work	làm bài tập về nhà
then, why did you call me	sau đó, tại_sao bạn lại gọi cho tôi
i found a love, for me	tôi đã tìm thấy một tình_yêu , cho tôi
i asked you to come yesterday, but you did not come	tôi đã yêu_cầu bạn đến ngày hôm_qua, nhưng bạn đã không đến
i pickup very fast. i become experienced in just a very short period	tôi đón rất nhanh . tôi trở_nên có kinh_nghiệm chỉ trong một khoảng thời_gian rất ngắn
keep yourself cool	giữ cho mình mát_mẻ
can i have a seat, please	tôi có_thể có một chỗ ngồi được không
my friend surya is getting married next month	bạn tôi surya sẽ kết_hôn vào tháng_tới
you dislike peaches	bạn không thích đào
did i ask you to resign the job	tôi đã yêu_cầu bạn từ_chức công_việc
what is your favorite historical movie	bộ phim lịch_sử yêu_thích của_bạn là_gì
do you have internet connection	bạn có kết_nối internet không
you should have attended the wedding	bạn nên tham_dự đám_cưới
how is suresh studying	suresh đang học như thế_nào
is it 8-3 coach	có phải là huấn_luyện_viên 8-3
can you learn to speak english just in 60 days	bạn có_thể học nói tiếng anh_ấychỉ sau 60 ngày không
your aunt called this morning. she has asked you to come to her house tomorrow	dì của_bạn đã gọi sáng nay . cô_ấy đã yêu_cầu bạn đến nhà cô_ấy vào ngày_mai
do you have any recommendations for scenic hikes	bạn có bất_kỳ khuyến_nghị cho việc đi bộ danh_lam thắng_cảnh
does he add wealth	anh_ta có thêm sự giàu_có không
may i know who is speaking	tôi có_thể biết ai đang nói không
i got a letter from the h.m. asking me to meet him	tôi nhận được một lá thư từ h.m.yêu cầu tôi gặp anh_ấy
hey nagaraj. the manager has asked you to wait till he returns	này nagaraj . người quản_lý đã yêu_cầu bạn đợi cho đến khi anh_ta trở về
can you take a photo of us	bạn có_thể chụp ảnh chúng_tôi không
what is your aim in life	mục_tiêu của_bạn trong cuộc_sống là_gì
california is never wet during november	california không_bao_giờ bị ướt trong tháng_11
i am adjani calling from mumbai	tôi đang gọi từ mumbai
my father, my mother, my grand father, my grand mother, my sister and myself	bố tôi, mẹ tôi, cha tôi, mẹ tôi, chị_gái tôi và chính tôi
shall i ask him to call you back	tôi có nên yêu_cầu anh_ấy gọi lại cho bạn không
to test the limits and break through	để kiểm_tra các giới_hạn và vượt qua
he is 10 years old	anh_ấy 10 tuổi
could i use your phone	tôi có_thể dùng điện_thoại của_bạn được không
they like pears	họ thích lê
everybody is fine	mọi người đều ổn
california is beautiful during january	california rất đẹp trong tháng_1
he came by car	anh_ấy đến bằng xe_hơi
the police ought to control the traffic	cảnh_sát nên kiểm_soát giao_thông
when i saw you in that dress, looking so beautiful	khi tôi nhìn thấy bạn trong chiếc váy đó , trông thật đẹp
my name is raja	tên tôi là raja
i will never forget your timely help	tôi sẽ không_bao_giờ quên sự giúp_đỡ kịp_thời của_bạn
remember the date	nhớ ngày
what is your favorite type of chocolate	loại sô_cô la yêu_thích của_bạn là_gì
would you mind telling me when we get there? i am new to this town	bạn có phiền nói với tôi khi chúng_tôi đến đó không ? tôi mới đến thị_trấn này
i have a dull feeling	tôi có một cảm_giác buồn_tẻ
california is never rainy during winter	california không_bao_giờ mưa trong mùa_đông
do you have any recommendations for historical walks	bạn có bất_kỳ khuyến_nghị cho các cuộc đi bộ lịch_sử
do you have any recommendations for historic village	bạn có bất_kỳ đề_xuất nào cho các làng lịch s
take my hand, stop, put van the man on the jukebox	nắm tay tôi , dừng lại , đặt van_the man vào máy_hát tự_động
paris is mild during summer	paris ôn_hòa trong mùa_hè
grab on my waist and put that body on me	nắm lấy eo của tôi và đặt cơ_thể đó vào tôi
she is my elder sister	cô_ấy là chị_gái của_tôi
mahesh called and said mr. surya had come from mumbai. he has asked you to meet him at welcome hotel room no.302	mahesh gọi và nói rằng ông surya đã đến từ mumbai . anh_ấy đã yêu_cầu bạn gặp anh_ấy tại welcome_hotel_room_số 302
are you working anywhere at present	bạn đang làm_việc ở bất_cứ đâu hiện_tại
what is your favorite holiday	kỳ nghỉ yêu_thích của_bạn là_gì
i am a graduate in engineering	tôi tốt_nghiệp kỹ_thuật
sir, i have been in the field of marketing for 5 years. i like the job that involves marketing. and i am good at it	thưa ông, tôi đã ở trong lĩnh_vực tiếp_thị trong 5 năm . tôi thích công_việc liên_quan đến tiếp_thị . và tôi giỏi về nó
did he combine the sentences	anh_ấy đã kết_hợp các câu
i don't like travelling by crowded buses	tôi không thích đi du_lịch bằng xe_buýt đông_đúc
i want to leave the job for better prospects	tôi muốn rời khỏi công_việc để có triển_vọng tốt hơn
is it serious	nó có nghiêm_trọng không
is she cutting a tree	cô_ấy đang cắt một cái cây
meet them in person	gặp họ trực_tiếp
china is sometimes pleasant during march	trung_quốc đôi_khi dễ_chịu trong tháng_3
i have three brothers and two sisters	tôi có ba anh_trai và hai chị gái
what is your favorite music genre	thể_loại âm_nhạc yêu_thích của_bạn là_gì
ask my mother not to worry about me	yêu_cầu mẹ tôi đừng lo_lắng cho tôi
i don't have any cash	tôi không có tiền_mặt
the apple is our least favorite fruit	quả táo là trái_cây ít yêu_thích nhất của chúng_tôi
i am sorry	tôi xin_lỗi
how is it	nó thế_nào
he is not available. i will be glad to help you	anh_ấy không tồn_tại . tôi sẽ rất vui_lòng giúp bạn
do you think i am not aware of it	bạn có nghĩ rằng tôi không biết về nó
you belong to which place	bạn thuộc về nơi nào
he came to my office to ask for money	anh_ấy đến văn_phòng của_tôi để xin tiền
when are you completing the computer course	khi nào bạn hoàn_thành khóa học máy_tính
meet me tomorrow	gặp tôi vào ngày_mai
he is bird	anh_ấy là chim
what do you want	bạn muốn gì
what is your manager's name	tên người quản_lý của_bạn là_gì
don't disturb me	đừng làm_phiền tôi
can i have a menu, please	tôi có_thể có một thực_đơn được không
don't move	đừng di_chuyển
who told you that i was not well	ai nói với bạn rằng tôi không khỏe
don't you have change	bạn không có thay_đổi
we don't trust in him	chúng_tôi không tin_tưởng vào anh_ấy
where are my books	những cuốn sách của_tôi ở_đâu
how has he performed in the exams	anh_ấy đã thực_hiện như thế_nào trong các kỳ thi
i am mrs. radha. i have come here regarding my son mahesh's admission in your school	tôi là bà radha . tôi đã đến đây liên_quan đến việc nhập_học maheshs của con_trai tôi trong trường của_bạn
have you received my e-mail	bạn nhận được email của_tôi chưa
do you think you are very smart	bạn có nghĩ rằng bạn rất thông_minh
paris is never freezing during november	paris không_bao_giờ đóng_băng trong tháng_11
when did you join this course	bạn tham_gia khóa học này khi nào
i would like to admit my daughter mary in your school	tôi muốn thừa_nhận con_gái mary của_tôi trong trường của_bạn
india is never dry during january	ấn_độ_không bao_giờ khô trong tháng_1
come, come on now, follow my lead	hãy đến , đến ngay bây_giờ , làm theo sự dẫn_dắt của tôi
when do you leave for office	khi nào bạn rời khỏi văn_phòng
why are you getting angry unnecessarily	tại_sao bạn lại tức_giận không cần_thiết
you look so beautiful in white, yeah yeah	bạn trông thật đẹp màu trắng , vâng
she drives that little red truck 	cô_ấy lái chiếc xe_tải nhỏ màu_đỏ đó
ask him to wait till i come	yêu_cầu anh_ta đợi cho đến khi tôi đến
how is your sister	chị của_bạn thế_nào
and leave and get in a taxi, then kiss in the backseat	và rời đi và lên taxi , sau đó hôn vào ghế sau
france is snowy during may	pháp có tuyết trong tháng_5
i see my future in your eyes	tôi thấy tương_lai của tôi trong mắt bạn
do you avoid me	bạn có tránh tôi không
tamil is spoken there	tamil được nói ở đó
is shyamala residing here	shyamala có cư_trú ở đây không
your love was handmade for somebody like me	tình_yêu của bạn đã được làm thủ_công cho ai đó như tôi
have i ever asked you to work on sundays	tôi đã bao_giờ yêu_cầu bạn làm_việc vào chủ_nhật chưa
tell the driver make the radio play, and i am singing like	nói với người lái_xe làm cho đài_phát_thanh , và tôi đang hát như
what is your favorite fashion accessory	phụ_kiện thời_trang yêu_thích của_bạn là_gì
can i have a different topping, please	tôi có_thể có một topping khác nhau được không
they have no school tomorrow	họ không có trường_học vào ngày_mai
you should not have talked like that	bạn không nên nói_chuyện như vậy
did i ask you to keep the door open	tôi đã yêu_cầu bạn giữ cửa_mở
does the dog bark	chó có vỏ không
can you recommend a good coffee shop	bạn có_thể giới_thiệu một quán cà_phê tốt không
ask him to bring his father tomorrow	yêu_cầu anh_ấy mang cha mình vào ngày_mai
na na na na	na na na
i have a bitter taste in the mouth	tôi có một vị đắng trong miệng
are you employed	bạn có được tuyển_dụng không
is it john's residence	có phải là nơi cư_trú của johns
my mother is very affectionate	mẹ tôi rất tình_cảm
can i have a different type of dessert, please	tôi có_thể có một loại món tráng_miệng khác nhau được không
how is the weather today	thời_tiết hôm_nay thế_nào
how do i get to the city center	làm_cách_nào để đến trung_tâm thành_phố
i could not return the book yesterday. i am so sorry	tôi không_thể trả lại cuốn sách ngày hôm_qua . tôi rât tiêc
we like strawberries	chúng_tôi thích dâu_tây
can i have the bill, please	tôi có_thể có hóa_đơn được không
i feel shy	tôi cảm_thấy nhút_nhát
is it jolarpet	có phải là jolarpet
we are still kids, but we are so in love	chúng_tôi vẫn là những đứa trẻ , nhưng chúng_tôi rất yêu
i feel hungry	tôi cảm_thấy đói
what is your favorite type of car	loại xe yêu_thích của_bạn là_gì
can i have a different style of music, please	tôi có_thể có một phong_cách âm_nhạc khác nhau được không
what is the minimum balance i should keep to have cheque book facility	số_dư tối_thiểu tôi nên giữ để có cơ_sở kiểm_tra sổ_sách là bao_nhiêu
california is never pleasant during winter	california không_bao_giờ dễ_chịu trong mùa_đông
what is your favorite food	món ăn yêu_thích của_bạn là_gì
don't shout	đừng hét lên
where is he working now	bây_giờ anh_ấy đang làm_việc ở_đâu
what is your favorite historical artifact	cổ_vật lịch_sử yêu_thích của_bạn là_gì
her most loved fruit is the grapefruit	trái_cây được yêu_thích nhất của cô_ấy là quả bưởi
there is plenty of water	có rất nhiều nước
what is your favorite subject in school	môn_học yêu_thích của_bạn ở trường là_gì
china is usually snowy during autumn	trung_quốc thường có tuyết trong mùa_thu
will you meet me	bạn sẽ gặp tôi chứ
i may go to delhi tomorrow	tôi có_thể đến delhi vào ngày_mai
please try this dish	hãy thử món ăn này
no. i have a very busy schedule in the morning	không . tôi có một lịch_trình rất bận_rộn vào buổi sáng
can i take rice and curd	tôi có_thể uống gạo và sữa đông không
what is your favorite historica	lịch_sử yêu_thích của_bạn là g
california is never cold during may	california không_bao_giờ lạnh trong tháng_năm
with you between my arms	với bạn giữa vòng_tay của tôi
i am terribly sorry. this is all entirely my fault	tôi rất lấy làm tiếc . đây hoàn_toàn là lỗi của_tôi
don't beat him	đừng đánh anh_ta
how long is he on leave	anh_ta nghỉ_phép bao_lâu
how do i get to the museum	làm thế_nào để tôi đến viện bảo_tàng
does the sun appear	mặt_trời có xuất_hiện không
new jersey is chilly during autumn	new_jersey lạnh_lẽo trong mùa_thu
i have a sense of giddiness	tôi có một cảm_giác ham chơi
you are all that i believe in	bạn là tất_cả những gì tôi tin_tưởng
do you have any recommendations for botanical gardens	bạn có bất_kỳ khuyến_nghị cho vườn_bách_thảo
i had my school education in london	tôi đã học ở trường_học ở london
are you busy right now	bây_giờ bạn có bận không
are you awake	bạn tỉnh_táo
not sure if you know this	không chắc bạn có biết điều này không
what is your favorite historical event	sự_kiện lịch_sử yêu_thích của_bạn là_gì
china is never rainy during november	trung_quốc không_bao_giờ mưa trong tháng_11
how did you locate the house	làm thế_nào bạn định_vị ngôi_nhà
i like getting wet in the rain	tôi thích bị ướt trong mưa
what the hell do you want	mày muốn cái quái gì vậy
when is your birthday	bạn sinh ngày nào
what is your favorite sports team	đội thể_thao yêu_thích của_bạn là_gì
i am pleased to have you here	tôi rất vui khi có bạn ở đây
there is a well but the water is brackish	có một cái giếng nhưng nước là nước_lợ
and now my bedsheets smell like you	và bây_giờ tấm trải giường của tôi có mùi như bạn
do you know any hardware engineer	bạn có biết bất_kỳ kỹ_sư phần_cứng
take these tablets for three days	lấy những viên thuốc này trong ba ngày
he has no time	anh_ấy không có thời_gian
are you tired	bạn có mệt không
he came here alone	anh_ấy đến đây một_mình
i am working in google	tôi đang làm_việc trong google
what is your favorite type of cheese	loại phô mai yêu_thích của_bạn là_gì
barefoot on the grass	chân trần trên cỏ
bolt the door	bolt cánh cửa
on what format have you sent the file	bạn đã gửi tệp định_dạng nào
the peach is her favorite fruit	đào là trái_cây yêu_thích của cô_ấy
what do you have for your breakfast	bạn có gì cho bữa sáng của mình
what is your favorite restaurant	nhà_hàng yêu_thích của_bạn là_gì
can i have a refund, please	tôi có_thể hoàn_lại tiền được không
paris is wonderful during march	paris thật tuyệt_vời trong tháng_ba
i am afraid, i can not come on sunday	tôi sợ, tôi không_thể đến vào chủ_nhật
you are my every reason	bạn là mọi lý_do của tôi
keep your word	giữ lời của_bạn
why do you always wear blue shirts	tại_sao bạn luôn mặc áo sơ_mi màu_xanh
i did not ask you to go there	tôi đã không yêu_cầu bạn đến đó
he is my grandfather	anh_ấy là ông tôi
note the address	lưu_ý địa_chỉ
'cause you only need the light when it is burning low	vì bạn chỉ cần ánh_sáng khi nó đang cháy thấp
i have a burning sensation in the eyes	tôi có một cảm_giác nóng rát trong mắt
it is very congested here	nó rất tắc_nghẽn ở đây
what is your favorite tv show	chương_trình truyền_hình yêu_thích của_bạn là_gì
she dislikes oranges and grapefruit 	cô_ấy không thích cam và bưởi
where is your godown	godown của_bạn ở_đâu
can i have a larger size	tôi có_thể có kích_thước lớn hơn không
can you help me, please	bạn co thể giup tôi được không
do i require installation for opening the cd	tôi có yêu_cầu cài_đặt để mở cd không
i am rather shy	tôi khá nhút_nhát
you must not come in with your shoes on	bạn không được đi vào với đôi giày của_bạn trên
don't tell lies	đừng nói_dối
ours is a modern, liberal family	chúng_ta là một gia_đình hiện_đại, tự_do
would you please hold on	bạn vui_lòng giữ
can i speak to mr. suresh please	tôi có_thể nói_chuyện với ông suresh được không
do you have any recommendations for boat tours	bạn có bất_kỳ khuyến_nghị cho các tour du_lịch thuyền
there is a numb feeling in the leg	có một cảm_giác tê ở chân
he has a friend in mumbai	anh_ấy có một người_bạn ở mumbai
he came to meet my father	ông đến gặp bố tôi
i’m angry. you broke my promise	tôi đang tức_giận . bạn đã phá vỡ lời hứa của_tôi
stop telling me what to do and mind your business	đừng nói với tôi những gì phải làm và quan_tâm đến việc kinh_doanh của_bạn
nothing like that will happen again. don't worry	không có gì như_thế sẽ xảy ra một lần nữa . đừng lo_lắng
what is your favorite musical instrument	nhạc_cụ yêu_thích của_bạn là_gì
let it go, let it go	hãy để nó đi , hãy để nó đi
with whom did he come	anh_ấy đã đến với ai
california is busy during november	california đang bận_rộn trong tháng_11
sir, there is a call for you	thưa ông, có một cuộc gọi cho ông
show him around the city	chỉ cho anh_ấy xung_quanh thành_phố
how frequently do you check your mail	bạn thường_xuyên kiểm_tra thư của mình như thế_nào
i found the one and	tôi đã tìm thấy một và
does he attend the function	anh_ta có tham_dự chức_năng không
how much is this	cái này bao_nhiêu
how do i get to the nearest convenience store	làm_cách_nào để đến cửa_hàng tiện_lợi gần nhất
the grocer came this morning. he said that a part of last month's bill is still due. and he asked us to clear it this month	người bán tạp_hóa đến sáng nay . ông nói rằng một phần của hóa_đơn tháng_trước vẫn còn do . và anh_ấy yêu_cầu chúng_tôi xóa nó trong tháng_này
what is your favorite type of exercise	loại bài_tập yêu_thích của_bạn là_gì
i am very grateful to you	tôi rất biết_ơn bạn
is he binding a book	anh_ấy đang ràng_buộc một cuốn sách
which colour do you like	bạn thích màu_nào
you look so beautiful in white	bạn nhìn trông thật đẹp khi mặc màu trắng
what is your favorite type of dessert	loại món tráng_miệng yêu_thích của_bạn là_gì
i have my bank account in trichy	tôi có tài_khoản ngân_hàng của_tôi trong trichy
when is he expected	khi nào anh_ấy mong_đợi
paris is usually rainy during december	paris thường mưa trong tháng_12
ask him to bring the book	yêu_cầu anh_ta mang cuốn sách
we have birds	chúng_tôi có chim
sir, nobody is here by that name	thưa ông, không ai ở đây bằng cái tên đó
why is the train late	tại_sao tàu bị trễ
i need your help in this regard	tôi cần sự giúp_đỡ của_bạn về vấn_đề này
what language is spoken there	ngôn_ngữ nào được nói ở đó
where do you live	bạn sống ở_đâu
they will not mistake me	họ sẽ không nhầm_lẫn tôi
can you write it on a cd for me	bạn có_thể viết nó trên cd cho tôi không
california is never cold during march	california không_bao_giờ lạnh trong tháng_ba
does she have any problem	cô_ấy có vấn_đề gì không
sir, i have to be in delhi by this evening before 5.30	thưa ông, tôi phải ở delhi vào tối nay trước 5 h30
paris is never cold during october	paris không_bao_giờ lạnh trong tháng_10
don't waste my time	đừng lãng_phí thời_gian của_tôi
what is your favorite museum	bảo_tàng yêu_thích của_bạn là_gì
you should take care of your health	bạn nên chăm_sóc sức_khỏe của_bạn
she likes strawberries	cô_ấy thích dâu_tây
the united states is never beautiful during march	hoa_kỳ không_bao_giờ đẹp trong tháng_ba
i am leaving for bangalore tonight and i will be back after 10 days	tôi sẽ rời bangalore tối nay và tôi sẽ trở_lại sau 10 ngày
i am john	tôi là john
but dreams come slow, and they go so fast	nhưng những giấc mơ đến chậm , và chúng đi quá nhanh
china is hot during july	trung_quốc nóng trong tháng_bảy
do you have any recommendations for scenic hiking trail	bạn có bất_kỳ đề_xuất nào cho đường_mòn đi bộ đường dài
he dislikes pears	anh_ấy không thích lê
then, why did you ask me to come	sau đó, tại_sao bạn yêu_cầu tôi đến
can i have a different color scheme, please	tôi có_thể có một bảng_màu khác nhau được không
i think a virus has infected our computer	tôi nghĩ rằng một loại virus đã lây_nhiễm máy_tính của chúng_tôi
new jersey is sometimes hot during march	new_jersey đôi_khi nóng trong tháng_3
do you have any recommendations for scenic bike routes	bạn có bất_kỳ đề_xuất cho các tuyến xe_đạp danh_lam thắng_cảnh
sorry, i don't understand	xin_lỗi, tôi không hiểu
can i have an extra towel, please	tôi có_thể có thêm một chiếc khăn nữa không
i am fine	tôi ổn
i have some books	tôi có một_số sách
don't you have school today	bạn không có trường_học hôm_nay
yeah, and if she falls in love, we'll let her go	vâng , và nếu cô_ấy yêu , hãy để cô_ấy đi
he likes pears	anh_ấy thích lê
she likes bananas and grapes 	cô_ấy thích chuối và nho
anything to convey	bất_cứ điều gì để truyền_đạt
did the police arrest him	cảnh_sát đã bắt_giữ anh_ta
who asked you	ai hỏi bạn
i am sorry. i have broken the cup	tôi xin_lỗi . tôi đã phá vỡ chiếc cốc
mostly idlis, sometimes dosa or pongal	chủ_yếu là idlis, đôi_khi dosa hoặc pongal
did she ask me	cô_ấy đã hỏi tôi
come to the chat room on sunday at 3. i will be online	hãy đến phòng trò_chuyện vào chủ_nhật lúc 3 . tôi sẽ trực_tuyến
i don't know how to thank you	tôi không biết làm thế_nào để cảm_ơn bạn
whom should i meet to open the account	tôi nên gặp ai để mở tài_khoản
what do you do for a living	bạn làm nghề gì
is it s.m. travels	có phải là s . m . du_lịch
i have no objection	tôi không có sự phản_đối
drinking fast and then we talk slow	uống nhanh và sau đó chúng_ta nói chậm
do you have any recommendations for outdoor activities	bạn có bất_kỳ khuyến_nghị cho các hoạt_động ngoài_trời
i dislike peaches	tôi không thích đào
how often do you go there	bạn thường đến đó như thế_nào
sir, have we crossed jolarpet	thưa ông, chúng_ta đã vượt qua jolarpet chưa
shall we adjourn for dinner	chúng_ta sẽ hoãn lại để ăn tối
how was your day	ngày của_bạn thế_nào
you are welcome to visit our site	bạn được chào_đón để truy_cập trang_web của chúng_tôi
say, boy, let us not talk too much	nói , chàng trai , chúng_ta đừng nói quá nhiều
where do you want to go	bạn muốn đi đâu
how about water	làm thế_nào về nước
mala rang up this morning. her sister is getting engaged this friday. she asked us to be there by 4 o'clock	mala vang lên sáng nay . chị_gái của cô_ấy sẽ đính_hôn vào thứ_sáu này . cô_ấy yêu_cầu chúng_tôi ở đó 4 oclock
new jersey is usually beautiful during april	new_jersey thường rất đẹp trong tháng_tư
can i have the menu in english, please	tôi có_thể có menu bằng tiếng anh_ấyđược không
whose book is this	cuốn sách này là của ai
can i have a different scent	tôi có_thể có một mùi hương khác không
what is your favorite dessert	món tráng_miệng yêu_thích của_bạn là_gì
how do i get to the nearest bank	làm_cách_nào để đến ngân_hàng gần nhất
does he befit always	anh_ấy có luôn_luôn_luôn không
mind your business	hãy quan_tâm đến việc kinh_doanh của_bạn
can i have your number please	tôi có_thể có số của_bạn được không
i need to go to the airport	tôi cần đến sân_bay
tears don't solve any problem	nước_mắt không giải_quyết bất_kỳ vấn_đề
doctor, my weight has picked up again	bác_sĩ, cân nặng của_tôi đã tăng lần nữa
is introduction a must	giới_thiệu có phải không
you dislike bananas	bạn không thích chuối
i don't care what they are going to say	tôi không quan_tâm những gì họ sẽ nói
the grapefruit is our least favorite fruit	quả bưởi là trái_cây yêu_thích nhất của chúng_tôi
do you need any help	bạn có cần giúp_đỡ không
how do i get to the nearest botanical garden	làm_cách_nào để đến vườn_bách_thảo gần nhất
the united states is sometimes beautiful during november	hoa_kỳ đôi_khi rất đẹp trong tháng_11
now i know i have met an angel in person	bây_giờ tôi biết tôi đã gặp một thiên_thần trong người
conceal, don't feel, don't let them know	che_giấu , đừng cảm_thấy , đừng cho họ biết
where is it going to be held	nó sẽ được tổ_chức ở_đâu
do you have any recommendations for local markets	bạn có bất_kỳ khuyến_nghị cho thị_trường địa_phương
bring them here	mang chúng đến đây
where do you keep your books	bạn giữ sách của mình ở_đâu
don't confuse me	đừng nhầm_lẫn tôi
ask them not to wait for me	yêu_cầu họ đừng đợi tôi
we are six persons	chúng_tôi là sáu người
keep cool	giữ mát
what did you do	bạn đã làm gì
she is going to the united states next summer 	cô_ấy sẽ đến hoa_kỳ vào mùa_hè tới
he is on the other line	anh_ấy ở trên đường khác
girl, you know i want your love	cô_gái , bạn biết tôi muốn tình_yêu của bạn
is ravi singing a song	ravi có đang hát một bài hát không
did the h.m announce the holiday	h.m đã công_bố ngày lễ
with all my heart i mean every word	với tất_cả trái_tim tôi , tôi có nghĩa là mọi lời_nói
why did you beat him	tại_sao bạn lại đánh_bại anh_ta
sir, i have done my b.com. and now i am doing my computer course	thưa ông, tôi đã thực_hiện b.com của mình . và bây_giờ tôi đang thực_hiện khóa học máy_tính của mình
i will take you there one day	tôi sẽ đưa bạn đến đó một ngày
ours is a small family	chúng_ta là một gia_đình nhỏ
is the machine working	máy có hoạt_động không
ask him to call me as soon as he returns	yêu_cầu anh_ấy gọi cho tôi ngay khi anh_ấy trở_lại
hereafter i will not go with them	sau đây tôi sẽ không đi với họ
i am sorry. i have disturbed you	tôi xin_lỗi . tôi đã làm phiền bạn
it is a beautiful day, isn't it	đó là một ngày đẹp trời, phải không
his favorite fruit is the orange	trái_cây yêu_thích của anh_ấy là màu_cam
do you have any recommendations for historic neighborhoods	bạn có bất_kỳ khuyến_nghị cho các khu_phố lịch_sử
he has to appear for an entrance test	anh_ta phải xuất_hiện cho một bài kiểm_tra đầu vào
would you like second serving	bạn có muốn phục_vụ thứ hai không
the house is spacious	ngôi_nhà rộng_rãi
can i have a different type of coffee, please	tôi có_thể có một loại cà_phê khác nhau được không
well, i found a girl, beautiful and sweet	chà , tôi đã tìm thấy một cô_gái , xinh_đẹp và ngọt_ngào
what is your favorite historical era	thời_đại lịch_sử yêu_thích của_bạn là_gì
a kingdom of isolation	một vương_quốc cô_lập
did you reach there on time	bạn đã đến đó đúng giờ
i am sorry, i don't know the answer	tôi xin_lỗi, tôi không biết câu trả_lời
i am outspoken	tôi thẳng_thắn
what is your favorite fashion style	phong_cách thời_trang yêu_thích của_bạn là_gì
sir. mr. siva is on leave today	quý ngài . ông siva đang nghỉ_phép hôm_nay
when does the vacation start	khi nào thì kỳ nghỉ bắt_đầu
love	yêu
i could have come by auto, but who would pay the fare	tôi có_thể đến bằng ô_tô, nhưng ai sẽ trả_giá vé
is the bus that just left gandhi nagar bus	có phải xe_buýt vừa rời khỏi xe_buýt gandhi_nagar
i apologise for talking to you like that	tôi xin_lỗi vì đã nói_chuyện với bạn như thế
you are always complaining about something	bạn luôn phàn_nàn về điều gì đó
is she calling your sister	cô_ấy đang gọi em_gái của_bạn
if i miss it, i stand to a great loss. please help me out sir	nếu tôi bỏ lỡ nó, tôi sẽ chịu một sự mất_mát lớn . xin hãy giúp tôi ra
they dislike grapes	họ không thích nho
i just go through the headlines	tôi chỉ đi qua các tiêu_đề
what is your favorite type of gemstone	loại đá_quý yêu_thích của_bạn là_gì
my soul is spiraling in frozen fractals all around	linh_hồn của tôi đang xoắn_ốc trong các vết rồng đông_lạnh xung_quanh
do you have any recommendations for scenic viewpoints	bạn có bất_kỳ đề_xuất cho quan_điểm_danh_lam thắng_cảnh
did you type the letter	bạn đã nhập chữ_cái
in case of	trong trường_hợp
and she looks perfect	và cô_ấy trông hoàn_hảo
do you have atm facility	bạn có cơ_sở atm không
how did you reach there	làm thế_nào bạn đến đó
how do i say this in english	làm thế_nào để tôi nói điều này bằng tiếng anh
he has a car	anh_ấy có một chiếc xe_hơi
why is he leaving that school	tại_sao anh_ta rời trường đó
how do i get to the nearest hotel	làm_cách_nào để đến khách_sạn gần nhất
oh, well	ồ, tốt
what is your favorite historical city	thành_phố lịch_sử yêu_thích của_bạn là_gì
but darling, just kiss me slow	nhưng em_yêu , hãy hôn em chậm
oh. sure	ồ. chắc_chắn
if i had been awake, i would have caught the thief	nếu tôi đã tỉnh_táo, tôi sẽ bắt được tên trộm
can i have the vegetarian menu, please	tôi có_thể có thực_đơn chay được không
i’m happy. you are my best friend	tôi đang hạnh_phúc . bạn là người_bạn tốt nhất của_tôi
how is everybody	mọi người thế_nào
shall i ask mr. hari to go to the bank	tôi có nên yêu_cầu ông hari đến ngân_hàng không
he came by bus	anh_ta đến bằng xe_buýt
paris is sometimes relaxing during summer	paris đôi_khi thư_giãn trong mùa_hè
sir, nobody by that name here	thưa ông, không ai biết tên đó ở đây
the orange is her least liked fruit	màu_cam là trái_cây ít thích nhất của cô_ấy
is ashwin giving a lecture	ashwin có giảng bài không
he is my neighbour	anh_ấy là hàng_xóm của_tôi
what is your favorite historical monument	đài tưởng_niệm lịch_sử yêu_thích của_bạn là_gì
new jersey is busy during december	new_jersey đang bận_rộn trong tháng_12
would you like something to drink	bạn có muốn uống gì không
you may feel hungry on the way	bạn có_thể cảm_thấy đói trên đường
how do i get to the nearest bus station	làm_cách_nào để đến trạm xe_buýt gần nhất
what is your favorite wildlife reserve	khu bảo_tồn động_vật hoang_dã yêu_thích của_bạn là_gì
could you tell us something about your family	bạn có_thể cho chúng_tôi biết điều gì đó về gia_đình của_bạn
can you repeat that, please	làm_ơn lập lại điều đó
where did you meet him	bạn đã gặp anh_ấy ở_đâu
does he act well	anh_ấy có hành_động tốt không
i am reserved by nature	tôi được bảo_lưu bởi thiên_nhiên
when will he be back	khi nào anh_ta sẽ trở_lại
thank you for reminding me	cảm_ơn bạn đã nhắc_nhở tôi
do you have any recommendations for city tours	bạn có bất_kỳ đề_xuất cho các tour du_lịch thành_phố
where does he live	anh_ấy sống ở_đâu
why did you behave like that	tại_sao bạn cư_xử như vậy
when do you return home	khi nào bạn trở_về nhà
he has office today	anh_ấy có văn_phòng hôm_nay
what should be my diet	chế_độ ăn_uống của_tôi là_gì
i will ask him to drop you	tôi sẽ yêu_cầu anh_ấy thả bạn
i am a post graduate in medicine	tôi tốt_nghiệp bài y_khoa
is there a jet airways flight to delhi	có chuyến bay phản_lực đến delhi không
did he arrange a function	anh_ta đã sắp_xếp một chức_năng
when will the school be over today	khi nào trường sẽ kết_thúc hôm_nay
no problem. you can post it tomorrow	không có gì . bạn có_thể đăng nó vào ngày_mai
she has a car	cô_ấy có một chiếc xe_hơi
shall we start	chúng_ta sẽ bắt_đầu
not knowing what it was	không biết nó là gì
i am clinton calling from london	tôi là bà clinton gọi từ london
i go by bus	tôi đi bằng xe_buýt
ask him to come tomorrow	yêu_cầu anh_ấy đến vào ngày_mai
good luck	chúc may_mắn
how do you manage	bạn quản_lý như thế_nào
it is very cold	trời rất lạnh
paris is never pleasant during september	paris không_bao_giờ dễ_chịu trong tháng_chín
have you got designer saree	bạn đã có nhà thiết_kế saree
do you have any recommendations for scenic drives	bạn có bất_kỳ đề_xuất cho các ổ_đĩa danh_lam thắng_cảnh
they live in at paris in france	họ sống ở paris ở pháp
can i speak to mr. obama	tôi có_thể nói_chuyện với ông obama không
where did he come	anh_ấy đã đến đâu
behave yourself, otherwise i will neck you out	hành_xử bản_thân, nếu không tôi sẽ cổ bạn ra
i have done my b.sc.	tôi đã thực_hiện bằng b.sc. của_tôi
what are your hobbies	sở_thích của_bạn là_gì
the house is roomy	ngôi_nhà rộng_rãi
it was nice of you to arrange everything at a short notice	thật tuyệt khi bạn sắp_xếp mọi thứ trong một thông_báo ngắn
when did you return from mumbai	bạn trở_về từ mumbai khi nào
well, you see her when you fall asleep	chà , bạn thấy cô_ấy khi bạn ngủ thiếp đi
can i take any message	tôi có_thể lấy bất_kỳ tin nhắn nào không
how long should i take rest	tôi nên nghỉ_ngơi trong bao_lâu
i love you	anh_ấyyêu em
keep the change	giữ sự thay_đổi
is your friend in london	có phải bạn của_bạn ở london
and trust me i will give it a chance now	và tin_tưởng tôi , tôi sẽ cho nó một cơ_hội ngay bây_giờ
how are you concerned with my affairs	bạn quan_tâm đến công_việc của_tôi như thế_nào
paris is rainy during winter	paris là mưa trong mùa_đông
dad… our driver kumar rang up. he said that his mother was not well. he could not come today	bố, tài_xế của chúng_tôi, kumar reo lên . anh_ấy nói rằng mẹ anh_ấy không khỏe . anh_ấy không_thể đến hôm_nay
darling, just dive right in and follow my lead	em_yêu , chỉ cần lặn ngay và đi theo sự dẫn_dắt của tôi
the banana is their favorite fruit	chuối là trái_cây yêu_thích của họ
he came here last week	anh_ấy đã đến đây tuần trước
don't make me angry	đừng làm tôi tức_giận
what is your sister's name	tên chị_em của_bạn là_gì
last night you were in my room	đêm qua bạn đã ở trong phòng của tôi
where can i find a pharmacy	tôi có_thể tìm một hiệu thuốc ở_đâu
new jersey is rainy during june	new_jersey là mưa trong tháng_6
but never to touch and never to keep	nhưng không bao_giờ chạm vào và không bao_giờ giữ
can i speak to mr. suresh, please	tôi có_thể nói_chuyện với ông suresh không
i should have joined this course last year	tôi nên tham_gia khóa học này vào năm_ngoái
whom did you come with	bạn đã đi cùng với ai
where to ask for prepaid taxi	yêu_cầu taxi trả trước ở_đâu
is maran taking your pen	maran có lấy cây_bút của_bạn không
what have you decided	những gì bạn đã quyết_định
there are eight members in our family	có tám thành_viên trong gia_đình của chúng_tôi
he came here yesterday	anh_ấy đã đến đây ngày hôm_qua
well, you only need the light when it is burning low	chà , bạn chỉ cần ánh_sáng khi nó đang cháy thấp
ask ramesh to wait for sometime	yêu_cầu ramesh chờ_đợi một lúc_nào đó
would you like to leave any message	bạn có muốn để lại bất_kỳ tin nhắn nào không
new jersey is usually quiet during fall	new_jersey thường im_lặng trong mùa_thu
my friend has asked me to give this letter to you	bạn tôi đã yêu_cầu tôi đưa bức thư này cho bạn
i don't have time	tôi không có thời_gian
i will walk her down the aisle	tôi sẽ đưa cô_ấy xuống lối đi
paris is relaxing during december	paris đang thư_giãn trong tháng_12
he likes strawberries	anh_ấy thích dâu_tây
how do i get to the nearest waterfall	làm_cách_nào để đến thác nước gần nhất
does she bind the grains	cô_ấy có ràng_buộc các loại ngũ_cốc không
my love is endless	tình_yêu của tôi là vô_tận
thank you very much	cảm_ơn rất nhiều
the mango is your least liked fruit	mango là trái_cây ít thích nhất của bạn
we are going out on our first date	chúng_tôi sẽ ra ngoài vào ngày đầu_tiên của chúng_tôi
you should have told me yesterday	bạn nên nói với tôi ngày hôm_qua
what is your favorite hiking trail difficulty level	mức_độ khó đi bộ đường dài yêu_thích của_bạn là_gì
you should rather have milk than coffee	bạn nên có sữa hơn cà_phê
will have and hold you	sẽ có và giữ bạn
where can i get the application form for opening sb account	tôi có_thể lấy mẫu_đơn để mở tài_khoản sb ở_đâu
can i have a different type of beer, please	tôi có_thể có một loại bia khác được không
you want to admit your son in which standard	bạn muốn thừa_nhận con_trai của_bạn trong tiêu_chuẩn nào
i asked you several times not to believe them, but you did not listen to me	tôi đã hỏi bạn nhiều lần để không tin họ, nhưng bạn đã không lắng_nghe tôi
i asked you not to go there. did you listen to me	tôi yêu_cầu bạn không đến đó . bạn đã lắng_nghe tôi
i am kala from mother computer graphics	tôi là kala từ đồ_họa máy_tính mẹ
maybe one day, you will understand why	có_thể một ngày nào đó bạn sẽ hiểu được tại_sao
is it true	nó có đúng không
how much us dollars (or british pounds) will i get	tôi sẽ nhận được bao_nhiêu đô_la mỹ ( hoặc bảng anh_ấy)
may i take the passport please	tôi có_thể lấy hộ_chiếu được không
the grapefruit is his least liked fruit	quả bưởi là trái_cây ít thích nhất của anh_ấy
i am mrs. radha, mother of suresh	tôi là bà radha, mẹ của suresh
next week my cousin is coming from mumbai	tuần tới, anh_ấyhọ của_tôi đến từ mumbai
are you a relative of mr. mohan	bạn có phải là người_thân của ông mohan
forget the past	quên đi quá_khứ
how are things	mọi thứ thế_nào
do i adopt a child	tôi có nhận nuôi một đứa trẻ không
i have completed my m.s	tôi đã hoàn_thành m.s
excuse me, where is the restroom	xin_lỗi, phòng vệ_sinh ở_đâu
i’m sad. can you cheer me up	tôi buồn . bạn có_thể cổ_vũ tôi không
why are you telling me all this	tại_sao bạn nói với tôi tất_cả những điều này
does the water boil	nước có sôi không
can i borrow this look for a day	tôi có_thể mượn cái nhìn này cho một ngày không
where can i collect the pass book	tôi có_thể thu_thập cuốn sách vượt qua ở_đâu
whatever it may be, you should not have beaten him	dù đó là_gì, bạn không nên đánh anh_ta
sir, i am a commerce graduate with a diploma in computer applications	thưa ông, tôi tốt_nghiệp thương_mại với bằng tốt_nghiệp về các ứng_dụng máy_tính
you should read a lot	bạn nên đọc rất nhiều
wake him up	gọi anh_ta dậy
don't talk about that	đừng nói về điều đó
do you have any recommendations for cultural events	bạn có bất_kỳ khuyến_nghị cho các sự_kiện văn_hóa
which is your home town	thị_trấn quê_nhà của_bạn là_gì
what about you	còn bạn thì sao
thanks a lot	cảm_ơn rất nhiều
she dislikes apples	cô_ấy không thích táo
how do you spell your name	bạn đánh_vần tên bạn như thế_nào
what is your favorite type of tree	loại cây yêu_thích của_bạn là_gì
nice to meet you	rất vui được gặp bạn
you are welcome	không có gì
my friend is very reliable	bạn tôi rất đáng tin_cậy
he saw a old yellow truck 	anh_ấy nhìn thấy một chiếc xe_tải màu_vàng cũ
could you allot a seat near the window	bạn có_thể phân_bổ một chỗ ngồi gần cửa_sổ
how is your married life	cuộc_sống hôn_nhân của_bạn thế_nào
of course madam i have it here	tất_nhiên thưa bà, tôi có nó ở đây
there is always a solution to any problem	luôn_luôn có một giải_pháp cho bất_kỳ vấn_đề
her most loved fruit is the lemon	trái_cây được yêu_thích nhất của cô_ấy là chanh
is reservation available for 16th on brindavan	có đặt phòng cho ngày 16 trên brindavan không
can i have a different style of cooking, please	tôi có_thể có một phong_cách nấu_ăn khác nhau được không
what is your favorite type of pasta	loại mì_ống yêu_thích của_bạn là_gì
how do you go to office	làm thế_nào để bạn đến văn_phòng
shall i ask sheela to send the email	tôi có nên yêu_cầu sheela gửi email không
well, now they know	tốt , bây_giờ họ biết
do you have any recommendations for nightlife	bạn có bất_kỳ khuyến_nghị cho cuộc_sống về đêm
if he had asked me, i would have given it to him	nếu anh_ấy hỏi tôi, tôi sẽ đưa nó cho anh_ấy
they came all the way to invite you	họ đã đến để mời bạn
he drives a new blue car 	anh_ta lái một chiếc_xe màu_xanh mới
yes. i have	đúng . tôi có
where do you have your bank account	bạn có tài_khoản ngân_hàng của mình ở_đâu
you had better carry something with you to eat	bạn nên mang theo thứ gì đó để ăn
how can i get to the train station	làm thế_nào tôi có_thể đến ga xe_lửa
all are fine	tất_cả đều ổn
are they from abroad	họ ở nước_ngoài
is he taking your cell phone	anh_ấy đang lấy điện_thoại_di_động của_bạn
can i have a table by the window, please	tôi có_thể có một cái bàn cạnh cửa_sổ được không
did i get clarity in my doubt	tôi đã nhận được sự rõ_ràng trong nghi_ngờ của_tôi
what date is today	hôm_nay là ngày mấy
will it rain today	hôm_nay trời có mưa không
paris is sometimes busy during june	paris đôi_khi bận_rộn trong tháng_6
it was so nice of you to have brought your family	thật tuyệt khi bạn đã mang gia_đình của_bạn
has the brindavan left	brindavan đã để lại
put on your shirt	mặc áo của_bạn
that is alright	không_sao đâu
i’m lost. can you show me the way	tôi đã mất . bạn có_thể chỉ tôi đường
nobody will believe that	không ai sẽ tin điều đó
he came along with his wife	anh_ấyđi cùng với vợ
why did not you inform me	tại_sao bạn không thông_báo cho tôi
i had my schooling in london	tôi đã đi học ở london
what is your name	tên bạn là_gì
new jersey is chilly during march	new_jersey lạnh_lẽo trong tháng_3
can i have a non-alcoholic drink, please	tôi có_thể uống đồ_uống không cồn được không
california is never busy during february	california không_bao_giờ bận_rộn trong tháng_hai
how has he done at the exams	anh_ấy đã làm như thế_nào tại các kỳ thi
did anybody come	có ai đến không
why did you go there	tại_sao bạn đến đó
how is the movie	phim thế_nào
i did not ask them to come here	tôi đã không yêu_cầu họ đến đây
why did not you apply for the job	tại_sao bạn không nộp đơn cho công_việc
i am sorry. i forgot to post the letter	tôi xin_lỗi . tôi quên đăng bức thư
is he bringing a file	có phải anh_ấy đang mang một tập tin
i am sure it was not your fault and everybody knows it	tôi chắc_chắn đó không_phải là lỗi của_bạn và mọi người đều biết điều đó
i am thirsty	tôi khát
sir, i have necessary qualifications and a lot of experience in this field, so i think i am fit for this job	thưa ông, tôi có trình_độ cần_thiết và rất nhiều kinh_nghiệm trong lĩnh_vực này, vì_vậy tôi nghĩ rằng tôi phù_hợp với công_việc này
i will bird	tôi sẽ chim
how do i get to the nearest national park	làm_cách_nào để đến công_viên quốc_gia gần nhất
who switched off the light	ai đã tắt đèn
doing a good job	làm một công_việc tốt
but you heard it	nhưng bạn đã nghe nó
is he coming regularly	anh_ấy có thường_xuyên đến không
how long should i take this medicine	tôi nên dùng thuốc này trong bao_lâu
what is your favorite type of vegetable	loại rau yêu_thích của_bạn là_gì
i have three sisters and a brother	tôi có ba chị_gái và một anh_trai
i feel feverish	tôi cảm_thấy sốt
stop worrying. everything will be alright	đưng lo lăng . mọi thứ sẽ ổn thôi
how is your friend suresh	bạn của_bạn suresh thế_nào
i get up at 5.15	tôi thức dậy lúc 5.15
which is your native town	thị_trấn bản_địa của_bạn là_gì
when is the sports day	khi nào là ngày thể_thao
i don't' feel like watching t.v	tôi không cảm_thấy muốn xem t.v
why did he come here	tại_sao anh_ấy đến đây
shall i ask them to wait	tôi có nên yêu_cầu họ đợi không
how do you say this in english	bạn nói điều này thế_nào trong tiếng anh
on which platform is the brindavan express	brindavan express trên nền_tảng nào
make a note of it	ghi_chú nó
is it us bank	có phải là ngân_hàng hoa_kỳ không
when is the next train	chuyến tàu tiếp_theo khởi_hành khi nào
did you call me	bạn đã gọi cho tôi
did you get my letter	bạn đã nhận được thư của_tôi chưa
are you afraid of them	bạn có sợ họ không
your lie in april	lời nói_dối của bạn vào tháng tư
she has two children	cô_ấy có hai con
california is never freezing during october	california không_bao_giờ đóng_băng trong tháng_mười
can i travel	tôi có_thể đi du_lịch không
the united states is warm during spring	hoa_kỳ ấm_áp trong mùa_xuân
the grape is their least liked fruit	nho là trái_cây ít thích nhất của họ
the house is commodious	ngôi_nhà là hàng_hóa
please have your seat	vui_lòng có chỗ ngồi của_bạn
there is no water problem at all	không có vấn_đề nước nào cả
to carry love, to carry children of our own	mang theo tình_yêu , mang theo con_cái của chúng_ta
you are supposed to complete the work by this evening	bạn phải hoàn_thành công_việc vào tối nay
sir, i have three years of experience in computer accounting	thưa ông, tôi có ba năm kinh_nghiệm trong kế_toán máy_tính
mr. varadharajan has asked us to attend the meeting without fail	ông varadharajan đã yêu_cầu chúng_tôi tham_dự cuộc họp mà không thất_bại
i have done my b.s. of engineering	tôi đã làm bằng b.s.của kỹ_thuật
ask sheela to shut up	yêu_cầu sheela im_lặng
when do you reopen the school	khi nào bạn mở lại trường_học
rain or shine, i will stand by you	mưa hay nắng, tôi sẽ đứng cạnh bạn
he dislikes lemons	anh_ấy không thích chanh
do you have a one rupee coin	bạn có một đồng_tiền rupee không
sir, i am ramesh kumar from alpha agencies. we were informed that our cheque is ready. whom should i meet to collect the cheque	thưa ông, tôi là ramesh_kumar từ các cơ_quan alpha . chúng_tôi đã được thông_báo rằng séc của chúng_tôi đã sẵn_sàng . tôi nên gặp ai để thu_thập séc
throw it out	ném nó ra ngoài
yes. certainly	đúng . chắc_chắn
how much is it	cái này giá bao_nhiêu
where are you from	bạn đến từ đâu
could i speak to mr. suresh please	tôi có_thể nói_chuyện với ông suresh được không
i like listening to music	tôi thích nghe nhạc
your least liked fruit is the grape	trái_cây ít thích nhất của bạn là nho
when are you completing the work	khi nào bạn hoàn_thành công việc
sir, i am to get down at gandhi nagar	thưa ông, tôi sẽ xuống gandhi_nagar
thanks for calling	cảm_ơn vì đã gọi
california is usually beautiful during winter	california thường đẹp trong mùa_đông
can i have a side of fries, please	tôi có_thể có một bên khoai_tây chiên được không
he is doing fine	anh_ấy đang làm tốt
life is not suffering all the time	cuộc_sống không_phải chịu_đựng mọi lúc
well, i found a woman, stronger than anyone i know	chà , tôi đã tìm thấy một người phụ_nữ , mạnh_mẽ hơn bất_cứ ai tôi biết
sir, i am to get down at ambur	thưa ông, tôi sẽ xuống ambur
india is chilly during summer	ấn_độ lạnh_lẽo trong mùa_hè
whom do you suspect	bạn nghi_ngờ ai
she dislikes lemons	cô_ấy không thích chanh
hello, how are you	xin chào bạn khỏe không
do you have any vegetarian options	bạn có bất_kỳ lựa_chọn ăn_chay nào không
visit this site if you want more information	truy_cập trang_web này nếu bạn muốn biết thêm thông_tin
there is scarcity of water	có sự khan_hiếm nước
why did he come	tại_sao anh_ấy đến
new jersey is sometimes nice during winter	new_jersey đôi_khi rất đẹp trong mùa_đông
what is your favorite hiking spot	điểm đi bộ đường dài yêu_thích của_bạn là_gì
i plan to visit california next may 	tôi dự_định đến thăm california vào tháng_5 tới
you like apples	bạn thích táo
what is the waiting list number	số danh_sách chờ là_gì
how many people work here	có bao_nhiêu người làm_việc ở đây
what is your favorite board game	trò_chơi yêu_thích của_bạn là_gì
it is ok with me, but you must ask the m.d	nó ổn với tôi, nhưng bạn phải hỏi m.d
please visit our site	vui_lòng truy_cập trang_web của chúng_tôi
i return home at 6.30	tôi trở về nhà lúc 6 h30
where do you buy your dresses	bạn mua váy của mình ở_đâu
can i have a window seat, please	tôi có_thể có một chỗ ngồi cửa_sổ được không
what is the weather like today	thời_tiết hôm_nay thế_nào
it was my mistake	đó là sai_lầm của_tôi
could not keep it in, heaven knows i tried	không_thể giữ nó vào , thiên_đường biết tôi đã thử
the water is hard	nước_cứng
he dislikes grapes	anh_ấy không thích nho
doctor, what is the problem with me	bác_sĩ, vấn_đề với tôi là_gì
we were birds	chúng_tôi là những con_chim
is mr. sadhasivam still working here	ông sadhasivam vẫn đang làm_việc ở đây
how many photos are needed	cần bao_nhiêu bức ảnh
is she going to delhi	cô_ấy sẽ đến delhi
can you help me with something	bạn co thể giúp tôi lam cai nay đươc không
when is the last day for paying the fees	ngày cuối_cùng để trả phí là khi nào
california is sometimes cold during winter	california đôi_khi lạnh trong mùa_đông
where do i come from	tôi đến từ đâu
sir, he is speaking over the other line	thưa ông, ông đang nói qua dòng khác
i go by cycle	tôi đi theo chu_kỳ
no right, no wrong, no rules for me	không đúng , không sai , không có quy_tắc cho tôi
and with this ring i	và với chiếc nhẫn này tôi
here i stand in the light of day	ở đây tôi đứng trong ánh_sáng ban_ngày
i go by train	tôi đi bằng tàu
be the good girl you always have to be	là cô_gái tốt mà bạn luôn phải
do you have your branch in erode	bạn có chi_nhánh của_bạn trong erode không
sir, he is out of town and he will be back only next week	thưa ông, ông ra khỏi thị_trấn và ông sẽ trở_lại vào tuần tới
do you have a computer at home	bạn có máy_tính ở nhà không
your most feared animal is that shark 	con_vật đáng sợ nhất của bạn là cá_mập đó
i am hungry	tôi đói
the strawberry is their least favorite fruit	quả_dâu là trái_cây ít yêu_thích nhất của họ
what is your favorite type of music	loại nhạc yêu_thích của_bạn là_gì
where are you living	bạn đang sống ở_đâu
when is your weekly off	khi nào là hàng tuần của_bạn
i’m bored. do you want to play a game	tôi chán . bạn có muốn chơi một trò_chơi
the lemon is my most loved fruit	chanh là trái_cây được yêu_thích nhất của tôi
the postman came again today. he said that if we did not collect the parcel by tomorrow, it would be sent back	người đưa thư lại đến ngày hôm_nay . anh_ấy nói rằng nếu chúng_tôi không thu_thập bưu_kiện vào ngày_mai, nó sẽ được gửi lại
we look for him at the library	chúng_tôi tìm anh_ấy tại thư_viện
i am ravi calling from madurai	tôi là ravi gọi từ madurai
what is your favorite beach	bãi_biển yêu_thích của_bạn là_gì
new jersey is freezing during winter	new_jersey đang đóng_băng trong mùa_đông
what is your favorite theater performance	buổi biểu_diễn nhà_hát yêu_thích của_bạn là_gì
i want to admit him in sixth standard	tôi muốn thừa_nhận anh_ấy trong tiêu_chuẩn thứ sáu
i am bird	tôi là chim
who said	ai nói
i don't find words to express my thanks to you	tôi không tìm thấy từ để diễn_tả lời cảm_ơn của_tôi đến bạn
i am a b.e. graduate	tôi là một b.e.tốt_nghiệp
we come from salem	chúng_tôi đến từ salem
your good name please	xin vui_lòng tên tốt của_bạn
get lost	bị lạc
it was nobody's fault. why do you worry	đó là lỗi nobodys . tại_sao bạn lo_lắng
please be seated	hãy ngồi
i know him in april	tôi biết anh_ấy vào tháng tư
new jersey is never wet during november	new_jersey không_bao_giờ bị ướt trong tháng_11
give it to them	đưa cho họ
i am kala calling from mother computer graphics	tôi đang gọi kala từ đồ_họa máy_tính của mẹ
what is your favorite hobby	sở_thích của_bạn là_gì
which bus goes to thiruvallur	xe_buýt nào đến thiruvallur
i don't mind it at all	tôi không bận_tâm đến nó cả
don't talk to me	đừng nói_chuyện với tôi
when is the sahara flight from delhi expected	khi nào chuyến bay sahara từ delhi dự_kiến
who is he	anh_ta là ai
he dislikes apples	anh_ấy không thích táo
sick	đau_ốm
the united states is never snowy during february	hoa_kỳ không_bao_giờ có tuyết trong tháng_hai
were you out of your mind to do such a thing	bạn đã mất_trí để làm một điều như vậy
reduce the volume	giảm âm_lượng
will they come here	họ sẽ đến đây
how do i get to the nearest art gallery	làm_cách_nào để đến phòng trưng_bày nghệ_thuật gần nhất
we will birds	chúng_tôi sẽ chim
how long have you been studying english	bạn đã học tiếng anh_ấyđược bao_lâu rồi
you just wait there. i will come and pick you up	bạn chỉ cần đợi ở đó . tôi sẽ đến và đón bạn
hey sundar, the manager has asked you to go to the bank	này sundar, người quản_lý đã yêu_cầu bạn đến ngân_hàng
he has asked you to meet him at his office tomorrow	anh_ấy đã yêu_cầu bạn gặp anh_ấy tại văn_phòng của anh_ấy vào ngày_mai
i’m sorry, i’m late	tôi xin_lỗi tôi đến trễ
i like people who are frank	tôi thích những người thẳng_thắn
why are you laughing	tại_sao bạn lại cười
can i have a glass of water	cho tôi xin ly nước
don't try my patience	đừng thử sự kiên_nhẫn của_tôi
can i have a different style of art, please	tôi có_thể có một phong_cách nghệ_thuật khác nhau không
i am friendly	tôi thân_thiện
i am working as a advertising agent. 	tôi đang làm_việc như một đại_lý quảng_cáo .
can i have a different type of salad dressing, please	tôi có_thể có một loại nước sốt salad khác nhau được không
is chitra calling priya	chitra đang gọi priya
what is your favorite historical book	cuốn sách_lịch_sử yêu_thích của_bạn là_gì
when are you leaving for madurai	khi nào bạn đi madurai
do they advertise a lot	họ có quảng_cáo nhiều không
how do i get to the nearest beach	làm_cách_nào để đến bãi biển gần nhất
what are you going to do	bạn định làm gì
new jersey is sometimes quiet during autumn	new_jersey đôi_khi yên_tĩnh trong mùa_thu
did i ask you to go there	tôi đã yêu_cầu bạn đến đó
how are you going to manage	bạn sẽ quản_lý như thế_nào
can you lend me some money	bạn có_thể cho tôi mượn một số tiền không
make people feel more comfortable	làm cho mọi người cảm_thấy thoải_mái hơn
not a footprint to be seen	không một dấu chân được nhìn thấy
and it looks like i am the queen	và có_vẻ như tôi là nữ_hoàng
your name please	làm_ơn cho xin tên
i am sorry for your loss	tôi xin_lỗi vì sự mất_mát của_bạn
i like walking in the morning sun	tôi thích đi bộ dưới ánh mặt_trời buổi sáng
how is your manager? is he a keralite	người quản_lý của_bạn thế_nào ?_anh_ấy có phải là keralite không
very good	rất tốt
eat slowly	ăn chậm thôi
is there anybody inside	có ai bên trong không
i really enjoyed it	tôi thực_sự rất thích nó
i have faith in what i see	tôi có niềm_tin vào những gì tôi thấy
'cause love comes slow, and it goes so fast	vì tình_yêu đến chậm , và nó đi quá nhanh
how do i get to the nearest historical site	làm_cách_nào để đến địa_điểm lịch_sử gần nhất
and one thought crystallizes like an icy blast	và một suy_nghĩ kết_tinh như một vụ nổ băng_giá
she likes mangoes	cô_ấy thích xoài
don't you have it in shades of blue	bạn không có nó trong sắc_thái của màu_xanh
the united states is never freezing during autumn	hoa_kỳ không_bao_giờ đóng_băng trong mùa_thu
did you return the book	bạn đã trả lại cuốn sách
i feel sleepy	tôi cảm_thấy buồn_ngủ
should i take these tablets before the meal or after the meal	tôi nên dùng những viên thuốc này trước bữa ăn hay sau bữa ăn
where are you buying the vegetables	bạn đang mua rau ở_đâu
i feel guilty	tôi cảm_thấy có tội
ours is an orthodox family	chúng_ta là một gia_đình chính_thống
nothing can be achieved by feeling depressed like this	không có gì có_thể đạt được bằng cách cảm_thấy chán_nản như thế này
does the govt. allot houses	có chính_phủ . nhà phân_bổ
you will never see me cry	bạn sẽ không bao_giờ thấy tôi khóc
is there nobody here at this counter? i have been waiting for half an hour	có ai ở đây tại quầy này không ? tôi đã chờ_đợi trong nửa giờ
can i have a different genre of literature, please	tôi có_thể có một thể_loại văn_học khác nhau không
ask ravi to finish the home work	yêu_cầu ravi hoàn_thành công việc nhà
only know you love her when you let her go	chỉ biết bạn yêu cô_ấy khi bạn để cô_ấy đi
what is the cost of living here	chi_phí sinh_hoạt ở đây là bao_nhiêu
where are you coming from	bạn đến từ đâu
can you complete the work in two days	bạn có_thể hoàn_thành công_việc trong hai ngày không
is the shop open	cửa_hàng có mở không
what is your favorite holiday destination	điểm đến kỳ nghỉ yêu_thích của_bạn là_gì
hide it up somewhere	ẩn nó ở_đâu_đó
will the train halt at arakkonam	chuyến tàu sẽ dừng lại ở arakkonam
what is your favorite movie	bộ phim yêu_thích của_bạn là_gì
sir, i must be in delhi this evening to attend an important meeting	thưa ông, tôi phải đến delhi tối nay để tham_dự một cuộc họp quan_trọng
forget it. anyone can make a mistake	quên đi . bất_cứ ai cũng có_thể phạm sai_lầm
how do i get to the nearest theater	làm_cách_nào để đến nhà_hát gần nhất
pay the bill	thanh_toán hóa đơn
paris is usually beautiful during september	paris thường đẹp trong tháng_9
have you taken a tc from the old school	bạn đã lấy một tc từ trường cũ
is she reading a novel	cô_ấy đang đọc một cuốn tiểu_thuyết
the pear is my most loved fruit	quả lê là trái_cây được yêu_thích nhất của tôi
did i ask them to wait	tôi đã yêu_cầu họ đợi
can we go to the practice now	chúng_ta có_thể đi thực_hành bây_giờ không
she dislikes that little red truck 	cô_ấy không thích chiếc xe_tải nhỏ màu_đỏ đó
i dislike grapefruit	tôi không thích bưởi
paris is usually wonderful during autumn	paris thường tuyệt_vời trong mùa_thu
can i have your e-mail id	tôi có_thể có id_e-mail của_bạn không
the united states is sometimes busy during january	hoa_kỳ đôi_khi bận_rộn trong tháng_1
do you have any recommendations for bike rentals	bạn có bất_kỳ khuyến_nghị cho cho thuê xe_đạp
how do i get to the nearest gas station	làm_cách_nào để đến trạm xăng gần nhất
nice of you to make it	rất vui khi làm cho nó
sir, mr. ravi is on the line	thưa ông, ông ravi đang trên đường
what is your educational qualification	bằng_cấp của_bạn là_gì
he is not available. would you like to speak to his assistant	anh_ấy không tồn_tại . bạn có muốn nói_chuyện với trợ_lý của anh_ấy không
don't beat about the bush	đừng đánh_bại về bụi rậm
dont get angry	đừng tức_giận
he knows my number	anh_ấy biết số của_tôi
how do i get to the nearest historical landmark	làm_cách_nào để đến địa_danh lịch_sử gần nhất
one week in we let the story begin	một tuần trong chúng_tôi để câu_chuyện bắt_đầu
sir, would you mind moving a bit	thưa ông, bạn có phiền di_chuyển một_chút không
sir, he has gone home for lunch	thưa ông, ông đã về nhà_ăn trưa
what is your favorite drink	bạn khoái uống gì nhất
by all means	bằng mọi cách
why fear as long as i am with you	tại_sao phải sợ_hãi miễn là tôi ở bên bạn
who are you	bạn là ai
an important meeting is going on. the m.d. has asked us not to allow anybody inside	một cuộc họp quan_trọng đang diễn ra . m.d. đã yêu_cầu chúng_tôi không cho_phép bất_cứ ai bên trong
what do you do on sundays	bạn làm gì vào chủ_nhật
can i have a different style of architecture, please	tôi có_thể có một phong_cách kiến_trúc khác nhau được không
switch off the t.v	tắt tivi
you seem to be a poor eater, why so	bạn dường_như là một người ăn nghèo, tại_sao như vậy
what time do you get up in the morning	bạn thức dậy lúc mấy giờ vào buổi sáng
i would rather go hungry than eat this food	tôi thà đi đói hơn là ăn thức_ăn này
china is sometimes chilly during march	trung_quốc đôi_khi lạnh_lẽo trong tháng_3
ask him to call me. he has my number	yêu_cầu anh_ấy gọi cho tôi . anh_ấy có số của_tôi
his father has been transferred to this/place	cha_anh đã được chuyển đến nơi này / địa_điểm
what is your favorite type of reptile	loại bò_sát yêu_thích của_bạn là_gì
hey are giving the bonus next week	này đang cho tiền thưởng vào tuần tới
attend to the phone	tham_dự vào điện_thoại
where do you wait for him	bạn đợi anh_ấy ở_đâu
how did you get there	bạn đến đó bằng cách nào
do you have any pets	bạn có nuôi con_gì không
their least liked fruit is the banana	trái_cây ít thích nhất của họ là chuối
just a moment please	một chốc lát thôi, làm_ơn
i don't mind	tôi không phiền
i don't feel like going out	tôi không cảm_thấy muốn đi ra ngoài
i am friendly person	tôi là người thân_thiện
come over and start up a conversation with just me	hãy đến và bắt_đầu một cuộc trò_chuyện chỉ với tôi
it is raining hard	trời đang mưa mạnh
did he ask you anything about that	anh_ấy đã hỏi bạn bất_cứ điều gì về điều đó
can i have the wifi password, please	tôi có_thể có mật_khẩu wifi được không
the united states is never rainy during january	hoa_kỳ không_bao_giờ mưa trong tháng_1
this is my younger brother	đây là em_trai của_tôi
what is the name of that girl	tên của cô_ấy gái đó là_gì
just a minute please. i will find out whether he is available	vui_lòng đợi một phút . tôi sẽ tìm_hiểu xem anh_ấy có sẵn không
why is he dull	tại_sao anh_ta buồn_tẻ
can i have a different type of meat, please	tôi có_thể có một loại thịt khác được không
they are going to france next june 	họ sẽ đến pháp vào tháng_6 tới
what is your favorite time of day	thời_gian yêu_thích trong ngày của_bạn là_gì
are you mr. murthy	ông là ông murthy
